rundate,this_period,foreign_region,foreign_country,UK_airport,foreign_airport,total_pax_this_period,total_pax_scheduled_this_period,total_pax_charter_this_period,total_pax_last_period,total_pax_scheduled_last_period,total_pax_charter_last_period,total_pax_percent
22/03/2018 09:29,201801,Unknown,Unknown,GATWICK,Unknown,0,0,0,32,0,32,-100
22/03/2018 09:29,201801,Unknown,Unknown,BELFAST CITY (GEORGE BEST),Unknown,0,0,0,1330,0,1330,-100
22/03/2018 09:29,201801,Unknown,Unknown,BRISTOL,Unknown,0,0,0,1070,0,1070,-100
22/03/2018 09:29,201801,WESTERN EUROPE-EU,AUSTRIA,GATWICK,INNSBRUCK,36263,32235,4028,38108,33315,4793,-4.841503
22/03/2018 09:29,201801,WESTERN EUROPE-EU,AUSTRIA,GATWICK,KLAGENFURT,1011,1011,0,0,0,0,0
22/03/2018 09:29,201801,WESTERN EUROPE-EU,AUSTRIA,GATWICK,SALZBURG,19633,16216,3417,21165,17262,3903,-7.238365
22/03/2018 09:29,201801,WESTERN EUROPE-EU,AUSTRIA,GATWICK,VIENNA,16927,16927,0,14419,14419,0,17.393717
22/03/2018 09:29,201801,WESTERN EUROPE-EU,AUSTRIA,HEATHROW,INNSBRUCK,6662,6662,0,3665,3665,0,81.773533
22/03/2018 09:29,201801,WESTERN EUROPE-EU,AUSTRIA,HEATHROW,SALZBURG,5013,5013,0,2115,2115,0,137.021277
22/03/2018 09:29,201801,WESTERN EUROPE-EU,AUSTRIA,HEATHROW,VIENNA,47710,47710,0,48299,48299,0,-1.219487
22/03/2018 09:29,201801,WESTERN EUROPE-EU,AUSTRIA,LUTON,INNSBRUCK,2913,2913,0,1359,1359,0,114.348786
22/03/2018 09:29,201801,WESTERN EUROPE-EU,AUSTRIA,LUTON,SALZBURG,2210,1192,1018,2315,1206,1109,-4.535637
22/03/2018 09:29,201801,WESTERN EUROPE-EU,AUSTRIA,LUTON,VIENNA,3943,3943,0,4262,4262,0,-7.484749
22/03/2018 09:29,201801,WESTERN EUROPE-EU,AUSTRIA,SOUTHEND,VIENNA,647,647,0,0,0,0,0
22/03/2018 09:29,201801,WESTERN EUROPE-EU,AUSTRIA,STANSTED,INNSBRUCK,1987,0,1987,1705,0,1705,16.539589
22/03/2018 09:29,201801,WESTERN EUROPE-EU,AUSTRIA,STANSTED,LINZ,2827,2827,0,2938,2938,0,-3.77808
22/03/2018 09:29,201801,WESTERN EUROPE-EU,AUSTRIA,STANSTED,SALZBURG,14595,13426,1169,9624,8591,1033,51.65212
22/03/2018 09:29,201801,WESTERN EUROPE-EU,AUSTRIA,STANSTED,VIENNA,5288,5288,0,7358,7358,0,-28.132645
22/03/2018 09:29,201801,WESTERN EUROPE-EU,AUSTRIA,BELFAST CITY (GEORGE BEST),SALZBURG,681,0,681,1239,0,1239,-45.03632
22/03/2018 09:29,201801,WESTERN EUROPE-EU,AUSTRIA,BELFAST INTERNATIONAL,SALZBURG,1118,0,1118,0,0,0,0
22/03/2018 09:29,201801,WESTERN EUROPE-EU,AUSTRIA,BIRMINGHAM,GRAZ,430,430,0,0,0,0,0
22/03/2018 09:29,201801,WESTERN EUROPE-EU,AUSTRIA,BIRMINGHAM,INNSBRUCK,2915,0,2915,3539,661,2878,-17.632099
22/03/2018 09:29,201801,WESTERN EUROPE-EU,AUSTRIA,BIRMINGHAM,SALZBURG,3479,1958,1521,2369,883,1486,46.855213
22/03/2018 09:29,201801,WESTERN EUROPE-EU,AUSTRIA,BIRMINGHAM,VIENNA,2289,2289,0,0,0,0,0
22/03/2018 09:29,201801,WESTERN EUROPE-EU,AUSTRIA,BRISTOL,INNSBRUCK,4904,2524,2380,4786,2570,2216,2.465524
22/03/2018 09:29,201801,WESTERN EUROPE-EU,AUSTRIA,BRISTOL,SALZBURG,3865,2162,1703,3489,2063,1426,10.776727
22/03/2018 09:29,201801,WESTERN EUROPE-EU,AUSTRIA,BRISTOL,VIENNA,2233,2233,0,2489,2489,0,-10.285255
22/03/2018 09:29,201801,WESTERN EUROPE-EU,AUSTRIA,EAST MIDLANDS INTERNATIONAL,SALZBURG,1921,743,1178,1966,614,1352,-2.288911
22/03/2018 09:29,201801,WESTERN EUROPE-EU,AUSTRIA,EDINBURGH,INNSBRUCK,2493,0,2493,2394,0,2394,4.135338
22/03/2018 09:29,201801,WESTERN EUROPE-EU,AUSTRIA,EDINBURGH,SALZBURG,1624,924,700,1315,1315,0,23.498099
22/03/2018 09:29,201801,WESTERN EUROPE-EU,AUSTRIA,EDINBURGH,VIENNA,2850,2850,0,2683,2683,0,6.224376
22/03/2018 09:29,201801,WESTERN EUROPE-EU,AUSTRIA,GLASGOW,SALZBURG,1241,0,1241,1353,0,1353,-8.277901
22/03/2018 09:29,201801,WESTERN EUROPE-EU,AUSTRIA,LEEDS BRADFORD,SALZBURG,978,978,0,969,969,0,0.928793
22/03/2018 09:29,201801,WESTERN EUROPE-EU,AUSTRIA,LIVERPOOL (JOHN LENNON),SALZBURG,1087,1087,0,991,991,0,9.687185
22/03/2018 09:29,201801,WESTERN EUROPE-EU,AUSTRIA,MANCHESTER,INNSBRUCK,8762,4016,4746,11465,6837,4628,-23.576101
22/03/2018 09:29,201801,WESTERN EUROPE-EU,AUSTRIA,MANCHESTER,SALZBURG,7372,4461,2911,6029,3399,2630,22.275668
22/03/2018 09:29,201801,WESTERN EUROPE-EU,AUSTRIA,MANCHESTER,VIENNA,5268,5268,0,5099,5099,0,3.314375
22/03/2018 09:29,201801,WESTERN EUROPE-EU,AUSTRIA,NEWCASTLE,INNSBRUCK,1225,1225,0,1242,1242,0,-1.36876
22/03/2018 09:29,201801,WESTERN EUROPE-EU,AUSTRIA,NEWCASTLE,SALZBURG,1331,1331,0,1338,1338,0,-0.523169
22/03/2018 09:29,201801,WESTERN EUROPE-EU,BELGIUM,GATWICK,BRUSSELS,201,201,0,0,0,0,0
22/03/2018 09:29,201801,WESTERN EUROPE-EU,BELGIUM,HEATHROW,BRUSSELS,51168,51168,0,46419,46419,0,10.230724
22/03/2018 09:29,201801,WESTERN EUROPE-EU,BELGIUM,LONDON CITY,ANTWERP,2795,2795,0,3835,3835,0,-27.118644
22/03/2018 09:29,201801,WESTERN EUROPE-EU,BELGIUM,SOUTHEND,ANTWERP,0,0,0,43,43,0,-100
22/03/2018 09:29,201801,WESTERN EUROPE-EU,BELGIUM,BELFAST CITY (GEORGE BEST),BRUSSELS,0,0,0,1077,1077,0,-100
22/03/2018 09:29,201801,WESTERN EUROPE-EU,BELGIUM,BIRMINGHAM,BRUSSELS,12318,12318,0,10765,10765,0,14.426382
22/03/2018 09:29,201801,WESTERN EUROPE-EU,BELGIUM,BRISTOL,BRUSSELS,3639,3639,0,4199,4199,0,-13.336509
22/03/2018 09:29,201801,WESTERN EUROPE-EU,BELGIUM,EAST MIDLANDS INTERNATIONAL,BRUSSELS,2145,2145,0,1251,1251,0,71.46283
22/03/2018 09:29,201801,WESTERN EUROPE-EU,BELGIUM,EDINBURGH,BRUSSELS,7579,7579,0,6370,6370,0,18.979592
22/03/2018 09:29,201801,WESTERN EUROPE-EU,BELGIUM,EDINBURGH,CHARLEROI,3992,3992,0,5747,5747,0,-30.537672
22/03/2018 09:29,201801,WESTERN EUROPE-EU,BELGIUM,EXETER,BRUSSELS,0,0,0,43,43,0,-100
22/03/2018 09:29,201801,WESTERN EUROPE-EU,BELGIUM,GLASGOW,CHARLEROI,2258,2258,0,2123,2123,0,6.358926
22/03/2018 09:29,201801,WESTERN EUROPE-EU,BELGIUM,MANCHESTER,BRUSSELS,18152,18152,0,15158,15158,0,19.751946
22/03/2018 09:29,201801,WESTERN EUROPE-EU,BELGIUM,MANCHESTER,CHARLEROI,11350,11350,0,14506,14506,0,-21.756515
22/03/2018 09:29,201801,WESTERN EUROPE-EU,BELGIUM,NEWCASTLE,BRUSSELS,1904,1904,0,1494,1494,0,27.443106
22/03/2018 09:29,201801,WESTERN EUROPE-EU,CROATIA,GATWICK,DUBROVNIK,522,522,0,462,462,0,12.987013
22/03/2018 09:29,201801,WESTERN EUROPE-EU,CROATIA,GATWICK,SPLIT,0,0,0,120,120,0,-100
22/03/2018 09:29,201801,WESTERN EUROPE-EU,CROATIA,HEATHROW,ZAGREB,9113,9113,0,10903,10903,0,-16.4175
22/03/2018 09:29,201801,WESTERN EUROPE-EU,CYPRUS,GATWICK,LARNACA,11227,11227,0,10514,10514,0,6.781434
22/03/2018 09:29,201801,WESTERN EUROPE-EU,CYPRUS,GATWICK,PAPHOS,9758,6981,2777,7699,5372,2327,26.743733
22/03/2018 09:29,201801,WESTERN EUROPE-EU,CYPRUS,HEATHROW,LARNACA,11862,11862,0,18649,18649,0,-36.393372
22/03/2018 09:29,201801,WESTERN EUROPE-EU,CYPRUS,LUTON,LARNACA,3351,3351,0,2422,2422,0,38.35673
22/03/2018 09:29,201801,WESTERN EUROPE-EU,CYPRUS,LUTON,PAPHOS,4983,4983,0,3219,3219,0,54.799627
22/03/2018 09:29,201801,WESTERN EUROPE-EU,CYPRUS,STANSTED,LARNACA,4498,4498,0,5036,5036,0,-10.683082
22/03/2018 09:29,201801,WESTERN EUROPE-EU,CYPRUS,STANSTED,PAPHOS,12163,11808,355,10250,9181,1069,18.663415
22/03/2018 09:29,201801,WESTERN EUROPE-EU,CYPRUS,BIRMINGHAM,LARNACA,3283,3283,0,4393,4393,0,-25.267471
22/03/2018 09:29,201801,WESTERN EUROPE-EU,CYPRUS,BIRMINGHAM,PAPHOS,1793,0,1793,1220,0,1220,46.967213
22/03/2018 09:29,201801,WESTERN EUROPE-EU,CYPRUS,BRISTOL,PAPHOS,3453,3453,0,2027,2027,0,70.350271
22/03/2018 09:29,201801,WESTERN EUROPE-EU,CYPRUS,EDINBURGH,PAPHOS,3161,3161,0,2677,2677,0,18.07994
22/03/2018 09:29,201801,WESTERN EUROPE-EU,CYPRUS,LIVERPOOL (JOHN LENNON),LARNACA,2982,2982,0,2942,2942,0,1.359619
22/03/2018 09:29,201801,WESTERN EUROPE-EU,CYPRUS,MANCHESTER,LARNACA,1605,1605,0,1595,1595,0,0.626959
22/03/2018 09:29,201801,WESTERN EUROPE-EU,CYPRUS,MANCHESTER,PAPHOS,11226,7909,3317,9969,7042,2927,12.609088
22/03/2018 09:29,201801,WESTERN EUROPE-EU,CYPRUS,NEWCASTLE,PAPHOS,1700,1700,0,1226,1226,0,38.662316
22/03/2018 09:29,201801,WESTERN EUROPE-EU,DENMARK,GATWICK,AALBORG,1802,1802,0,2316,2316,0,-22.193437
22/03/2018 09:29,201801,WESTERN EUROPE-EU,DENMARK,GATWICK,COPENHAGEN,61997,61997,0,57089,57089,0,8.597103
22/03/2018 09:29,201801,WESTERN EUROPE-EU,DENMARK,HEATHROW,BILLUND,6043,6043,0,6969,6969,0,-13.287416
22/03/2018 09:29,201801,WESTERN EUROPE-EU,DENMARK,HEATHROW,COPENHAGEN,47897,47897,0,64979,64979,0,-26.288493
22/03/2018 09:29,201801,WESTERN EUROPE-EU,DENMARK,LONDON CITY,BILLUND,1694,1694,0,1550,1550,0,9.290323
22/03/2018 09:29,201801,WESTERN EUROPE-EU,DENMARK,LUTON,BILLUND,168,168,0,0,0,0,0
22/03/2018 09:29,201801,WESTERN EUROPE-EU,DENMARK,LUTON,COPENHAGEN,9952,9952,0,57502,57502,0,-82.692776
22/03/2018 09:29,201801,WESTERN EUROPE-EU,DENMARK,SOUTHEND,BILLUND,0,0,0,67,67,0,-100
22/03/2018 09:29,201801,WESTERN EUROPE-EU,DENMARK,STANSTED,AALBORG,4356,4356,0,0,0,0,0
22/03/2018 09:29,201801,WESTERN EUROPE-EU,DENMARK,STANSTED,AARHUS (TIRSTRUP),6625,6625,0,5776,5776,0,14.698753
22/03/2018 09:29,201801,WESTERN EUROPE-EU,DENMARK,STANSTED,BILLUND,17120,17120,0,15455,15455,0,10.773213
22/03/2018 09:29,201801,WESTERN EUROPE-EU,DENMARK,STANSTED,COPENHAGEN,24696,24414,282,262,0,262,9325.954198
22/03/2018 09:29,201801,WESTERN EUROPE-EU,DENMARK,ABERDEEN,COPENHAGEN,1509,1509,0,2609,2609,0,-42.161748
22/03/2018 09:29,201801,WESTERN EUROPE-EU,DENMARK,ABERDEEN,ESBJERG,521,521,0,654,654,0,-20.336391
22/03/2018 09:29,201801,WESTERN EUROPE-EU,DENMARK,BIRMINGHAM,COPENHAGEN,5117,5117,0,5574,5574,0,-8.19878
22/03/2018 09:29,201801,WESTERN EUROPE-EU,DENMARK,BRISTOL,COPENHAGEN,2661,2661,0,2489,2489,0,6.910406
22/03/2018 09:29,201801,WESTERN EUROPE-EU,DENMARK,EDINBURGH,COPENHAGEN,13608,13608,0,14134,14134,0,-3.721523
22/03/2018 09:29,201801,WESTERN EUROPE-EU,DENMARK,MANCHESTER,AALBORG,211,211,0,0,0,0,0
22/03/2018 09:29,201801,WESTERN EUROPE-EU,DENMARK,MANCHESTER,BILLUND,2456,2456,0,2033,2033,0,20.80669
22/03/2018 09:29,201801,WESTERN EUROPE-EU,DENMARK,MANCHESTER,COPENHAGEN,24140,24140,0,23421,23421,0,3.069895
22/03/2018 09:29,201801,WESTERN EUROPE-EU,DENMARK,NEWCASTLE,COPENHAGEN,0,0,0,1579,1579,0,-100
22/03/2018 09:29,201801,WESTERN EUROPE-EU,FINLAND,GATWICK,ENONTEKIO,374,0,374,162,0,162,130.864198
22/03/2018 09:29,201801,WESTERN EUROPE-EU,FINLAND,GATWICK,HELSINKI,18501,18501,0,19422,19422,0,-4.742045
22/03/2018 09:29,201801,WESTERN EUROPE-EU,FINLAND,GATWICK,IVALO,1717,1536,181,0,0,0,0
22/03/2018 09:29,201801,WESTERN EUROPE-EU,FINLAND,GATWICK,KITTILA,3506,477,3029,6002,2494,3508,-41.586138
22/03/2018 09:29,201801,WESTERN EUROPE-EU,FINLAND,GATWICK,KUUSAMO,1514,0,1514,2004,0,2004,-24.451098
22/03/2018 09:29,201801,WESTERN EUROPE-EU,FINLAND,GATWICK,ROVANIEMI,4405,4249,156,3080,2941,139,43.019481
22/03/2018 09:29,201801,WESTERN EUROPE-EU,FINLAND,HEATHROW,HELSINKI,52010,52010,0,51256,51256,0,1.471047
22/03/2018 09:29,201801,WESTERN EUROPE-EU,FINLAND,BIRMINGHAM,ENONTEKIO,288,0,288,0,0,0,0
22/03/2018 09:29,201801,WESTERN EUROPE-EU,FINLAND,BOURNEMOUTH,ENONTEKIO,40,0,40,0,0,0,0
22/03/2018 09:29,201801,WESTERN EUROPE-EU,FINLAND,BRISTOL,KITTILA,1419,0,1419,1520,0,1520,-6.644737
22/03/2018 09:29,201801,WESTERN EUROPE-EU,FINLAND,EAST MIDLANDS INTERNATIONAL,ENONTEKIO,66,0,66,118,0,118,-44.067797
22/03/2018 09:29,201801,WESTERN EUROPE-EU,FINLAND,EDINBURGH,HELSINKI,701,701,0,498,498,0,40.763052
22/03/2018 09:29,201801,WESTERN EUROPE-EU,FINLAND,LEEDS BRADFORD,ENONTEKIO,152,0,152,0,0,0,0
22/03/2018 09:29,201801,WESTERN EUROPE-EU,FINLAND,MANCHESTER,ENONTEKIO,185,0,185,98,0,98,88.77551
22/03/2018 09:29,201801,WESTERN EUROPE-EU,FINLAND,MANCHESTER,HELSINKI,10327,10327,0,8091,8091,0,27.635645
22/03/2018 09:29,201801,WESTERN EUROPE-EU,FINLAND,MANCHESTER,IVALO,189,0,189,0,0,0,0
22/03/2018 09:29,201801,WESTERN EUROPE-EU,FINLAND,MANCHESTER,KITTILA,1906,0,1906,2996,474,2522,-36.381842
22/03/2018 09:29,201801,WESTERN EUROPE-EU,FINLAND,MANCHESTER,KUUSAMO,1524,0,1524,1813,0,1813,-15.94043
22/03/2018 09:29,201801,WESTERN EUROPE-EU,FINLAND,NEWCASTLE,ENONTEKIO,82,82,0,0,0,0,0
22/03/2018 09:29,201801,WESTERN EUROPE-EU,FRANCE,GATWICK,BORDEAUX,14838,14838,0,15039,15039,0,-1.336525
22/03/2018 09:29,201801,WESTERN EUROPE-EU,FRANCE,GATWICK,CHAMBERY,11050,0,11050,10453,0,10453,5.711279
22/03/2018 09:29,201801,WESTERN EUROPE-EU,FRANCE,GATWICK,GRENOBLE,28184,7844,20340,30890,12795,18095,-8.760117
22/03/2018 09:29,201801,WESTERN EUROPE-EU,FRANCE,GATWICK,LYON,21931,18143,3788,18406,16818,1588,19.151364
22/03/2018 09:29,201801,WESTERN EUROPE-EU,FRANCE,GATWICK,MARSEILLE,7346,7346,0,7872,7872,0,-6.681911
22/03/2018 09:29,201801,WESTERN EUROPE-EU,FRANCE,GATWICK,MONTPELLIER,7749,7749,0,7712,7712,0,0.479772
22/03/2018 09:29,201801,WESTERN EUROPE-EU,FRANCE,GATWICK,NANTES,9974,9974,0,10293,10293,0,-3.099194
22/03/2018 09:29,201801,WESTERN EUROPE-EU,FRANCE,GATWICK,NICE,27287,27287,0,27691,27691,0,-1.458958
22/03/2018 09:29,201801,WESTERN EUROPE-EU,FRANCE,GATWICK,PARIS (CHARLES DE GAULLE),32678,32678,0,29738,29738,0,9.886341
22/03/2018 09:29,201801,WESTERN EUROPE-EU,FRANCE,GATWICK,RENNES,782,782,0,1307,1307,0,-40.168324
22/03/2018 09:29,201801,WESTERN EUROPE-EU,FRANCE,GATWICK,TOULOUSE (BLAGNAC),16464,15191,1273,17951,16482,1469,-8.283661
22/03/2018 09:29,201801,WESTERN EUROPE-EU,FRANCE,HEATHROW,GRENOBLE,1436,853,583,2475,0,2475,-41.979798
22/03/2018 09:29,201801,WESTERN EUROPE-EU,FRANCE,HEATHROW,LYON,18232,18232,0,21442,21442,0,-14.970618
22/03/2018 09:29,201801,WESTERN EUROPE-EU,FRANCE,HEATHROW,MARSEILLE,14681,14681,0,17371,17371,0,-15.485579
22/03/2018 09:29,201801,WESTERN EUROPE-EU,FRANCE,HEATHROW,NICE,28394,28394,0,25190,25190,0,12.719333
22/03/2018 09:29,201801,WESTERN EUROPE-EU,FRANCE,HEATHROW,PARIS (CHARLES DE GAULLE),99092,99092,0,83312,83312,0,18.940849
22/03/2018 09:29,201801,WESTERN EUROPE-EU,FRANCE,HEATHROW,PARIS (ORLY),0,0,0,17586,17586,0,-100
22/03/2018 09:29,201801,WESTERN EUROPE-EU,FRANCE,HEATHROW,TOULOUSE (BLAGNAC),15433,15433,0,17719,17719,0,-12.901405
22/03/2018 09:29,201801,WESTERN EUROPE-EU,FRANCE,LONDON CITY,CHAMBERY,1232,1232,0,1779,1779,0,-30.747611
22/03/2018 09:29,201801,WESTERN EUROPE-EU,FRANCE,LONDON CITY,NANTES,0,0,0,1430,1430,0,-100
22/03/2018 09:29,201801,WESTERN EUROPE-EU,FRANCE,LONDON CITY,PARIS (CHARLES DE GAULLE),0,0,0,990,990,0,-100
22/03/2018 09:29,201801,WESTERN EUROPE-EU,FRANCE,LONDON CITY,PARIS (ORLY),6277,6277,0,8047,8047,0,-21.995775
22/03/2018 09:29,201801,WESTERN EUROPE-EU,FRANCE,LUTON,BEZIERS,2678,2678,0,2473,2473,0,8.289527
22/03/2018 09:29,201801,WESTERN EUROPE-EU,FRANCE,LUTON,BORDEAUX,3965,3965,0,4069,4069,0,-2.555911
22/03/2018 09:29,201801,WESTERN EUROPE-EU,FRANCE,LUTON,BREST,0,0,0,160,160,0,-100
22/03/2018 09:29,201801,WESTERN EUROPE-EU,FRANCE,LUTON,CHAMBERY,983,0,983,0,0,0,0
22/03/2018 09:29,201801,WESTERN EUROPE-EU,FRANCE,LUTON,CLERMONT FERRAND,0,0,0,216,216,0,-100
22/03/2018 09:29,201801,WESTERN EUROPE-EU,FRANCE,LUTON,GRENOBLE,1122,1122,0,912,912,0,23.026316
22/03/2018 09:29,201801,WESTERN EUROPE-EU,FRANCE,LUTON,LYON,7171,7171,0,6461,6452,9,10.989011
22/03/2018 09:29,201801,WESTERN EUROPE-EU,FRANCE,LUTON,MARSEILLE,1943,1943,0,160,160,0,1114.375
22/03/2018 09:29,201801,WESTERN EUROPE-EU,FRANCE,LUTON,NANTES,4134,4134,0,81,0,81,5003.703704
22/03/2018 09:29,201801,WESTERN EUROPE-EU,FRANCE,LUTON,NICE,3417,3417,0,4961,4961,0,-31.122758
22/03/2018 09:29,201801,WESTERN EUROPE-EU,FRANCE,LUTON,NIMES,3119,3119,0,2876,2876,0,8.449235
22/03/2018 09:29,201801,WESTERN EUROPE-EU,FRANCE,LUTON,PARIS (CHARLES DE GAULLE),22671,22671,0,24747,24747,0,-8.388896
22/03/2018 09:29,201801,WESTERN EUROPE-EU,FRANCE,LUTON,PARIS (ORLY),0,0,0,5118,5118,0,-100
22/03/2018 09:29,201801,WESTERN EUROPE-EU,FRANCE,LUTON,STRASBOURG,0,0,0,56,56,0,-100
22/03/2018 09:29,201801,WESTERN EUROPE-EU,FRANCE,LUTON,TOULOUSE (BLAGNAC),3023,3023,0,2572,2572,0,17.534992
22/03/2018 09:29,201801,WESTERN EUROPE-EU,FRANCE,SOUTHEND,CAEN,0,0,0,356,356,0,-100
22/03/2018 09:29,201801,WESTERN EUROPE-EU,FRANCE,SOUTHEND,LYON,699,699,0,469,469,0,49.040512
22/03/2018 09:29,201801,WESTERN EUROPE-EU,FRANCE,SOUTHEND,NANTES,0,0,0,68,68,0,-100
22/03/2018 09:29,201801,WESTERN EUROPE-EU,FRANCE,SOUTHEND,PARIS (CHARLES DE GAULLE),3370,3370,0,3595,3595,0,-6.258693
22/03/2018 09:29,201801,WESTERN EUROPE-EU,FRANCE,SOUTHEND,PARIS (ORLY),44,44,0,0,0,0,0
22/03/2018 09:29,201801,WESTERN EUROPE-EU,FRANCE,SOUTHEND,RENNES,3362,3362,0,2859,2859,0,17.593564
22/03/2018 09:29,201801,WESTERN EUROPE-EU,FRANCE,STANSTED,BERGERAC,4326,4326,0,4361,4361,0,-0.802568
22/03/2018 09:29,201801,WESTERN EUROPE-EU,FRANCE,STANSTED,BIARRITZ,4616,4616,0,4375,4375,0,5.508571
22/03/2018 09:29,201801,WESTERN EUROPE-EU,FRANCE,STANSTED,BORDEAUX,7486,7486,0,6858,6858,0,9.157189
22/03/2018 09:29,201801,WESTERN EUROPE-EU,FRANCE,STANSTED,CARCASSONNE,4180,4180,0,4238,4238,0,-1.36857
22/03/2018 09:29,201801,WESTERN EUROPE-EU,FRANCE,STANSTED,CHAMBERY,4581,949,3632,3875,935,2940,18.219355
22/03/2018 09:29,201801,WESTERN EUROPE-EU,FRANCE,STANSTED,DINARD,4341,4341,0,3380,3380,0,28.431953
22/03/2018 09:29,201801,WESTERN EUROPE-EU,FRANCE,STANSTED,GRENOBLE,6499,6499,0,4432,4432,0,46.638087
22/03/2018 09:29,201801,WESTERN EUROPE-EU,FRANCE,STANSTED,LA ROCHELLE,2358,2358,0,2292,2292,0,2.879581
22/03/2018 09:29,201801,WESTERN EUROPE-EU,FRANCE,STANSTED,LIMOGES,5639,5639,0,5989,5989,0,-5.844047
22/03/2018 09:29,201801,WESTERN EUROPE-EU,FRANCE,STANSTED,LYON,463,463,0,0,0,0,0
22/03/2018 09:29,201801,WESTERN EUROPE-EU,FRANCE,STANSTED,MARSEILLE,9560,9560,0,8251,8251,0,15.864744
22/03/2018 09:29,201801,WESTERN EUROPE-EU,FRANCE,STANSTED,NANTES,0,0,0,169,169,0,-100
22/03/2018 09:29,201801,WESTERN EUROPE-EU,FRANCE,STANSTED,NICE,11313,11313,0,2873,2873,0,293.769579
22/03/2018 09:29,201801,WESTERN EUROPE-EU,FRANCE,STANSTED,PARIS (CHARLES DE GAULLE),0,0,0,287,287,0,-100
22/03/2018 09:29,201801,WESTERN EUROPE-EU,FRANCE,STANSTED,PARIS (ORLY),71,71,0,0,0,0,0
22/03/2018 09:29,201801,WESTERN EUROPE-EU,FRANCE,STANSTED,PAU,167,167,0,179,179,0,-6.703911
22/03/2018 09:29,201801,WESTERN EUROPE-EU,FRANCE,STANSTED,PERPIGNAN,0,0,0,183,183,0,-100
22/03/2018 09:29,201801,WESTERN EUROPE-EU,FRANCE,STANSTED,POITIERS,2879,2879,0,3189,3189,0,-9.720916
22/03/2018 09:29,201801,WESTERN EUROPE-EU,FRANCE,STANSTED,RENNES,0,0,0,156,156,0,-100
22/03/2018 09:29,201801,WESTERN EUROPE-EU,FRANCE,STANSTED,TARBES-LOURDES INTERNATIONAL,2682,2682,0,2675,2675,0,0.261682
22/03/2018 09:29,201801,WESTERN EUROPE-EU,FRANCE,STANSTED,TOULON / HYERES,0,0,0,221,0,221,-100
22/03/2018 09:29,201801,WESTERN EUROPE-EU,FRANCE,STANSTED,TOULOUSE (BLAGNAC),16998,16998,0,8107,8107,0,109.670655
22/03/2018 09:29,201801,WESTERN EUROPE-EU,FRANCE,STANSTED,TOURS,2491,2491,0,2900,2900,0,-14.103448
22/03/2018 09:29,201801,WESTERN EUROPE-EU,FRANCE,ABERDEEN,PARIS (CHARLES DE GAULLE),7030,7030,0,5680,5680,0,23.767606
22/03/2018 09:29,201801,WESTERN EUROPE-EU,FRANCE,BELFAST INTERNATIONAL,BORDEAUX,0,0,0,252,0,252,-100
22/03/2018 09:29,201801,WESTERN EUROPE-EU,FRANCE,BELFAST INTERNATIONAL,LA ROCHELLE,292,0,292,0,0,0,0
22/03/2018 09:29,201801,WESTERN EUROPE-EU,FRANCE,BELFAST INTERNATIONAL,LYON,944,944,0,1075,1075,0,-12.186047
22/03/2018 09:29,201801,WESTERN EUROPE-EU,FRANCE,BELFAST INTERNATIONAL,PARIS (CHARLES DE GAULLE),5629,5629,0,5730,5730,0,-1.762653
22/03/2018 09:29,201801,WESTERN EUROPE-EU,FRANCE,BIRMINGHAM,CHAMBERY,4198,792,3406,4528,505,4023,-7.287986
22/03/2018 09:29,201801,WESTERN EUROPE-EU,FRANCE,BIRMINGHAM,FIGARI,38,0,38,0,0,0,0
22/03/2018 09:29,201801,WESTERN EUROPE-EU,FRANCE,BIRMINGHAM,GRENOBLE,3439,1748,1691,4120,2087,2033,-16.529126
22/03/2018 09:29,201801,WESTERN EUROPE-EU,FRANCE,BIRMINGHAM,LYON,2588,2588,0,2886,2886,0,-10.32571
22/03/2018 09:29,201801,WESTERN EUROPE-EU,FRANCE,BIRMINGHAM,NANTES,337,337,0,817,817,0,-58.75153
22/03/2018 09:29,201801,WESTERN EUROPE-EU,FRANCE,BIRMINGHAM,PARIS (CHARLES DE GAULLE),34405,34111,294,31012,31012,0,10.940926
22/03/2018 09:29,201801,WESTERN EUROPE-EU,FRANCE,BIRMINGHAM,PARIS (ORLY),264,264,0,56,56,0,371.428571
22/03/2018 09:29,201801,WESTERN EUROPE-EU,FRANCE,BIRMINGHAM,TOULOUSE (BLAGNAC),3224,1944,1280,3350,2356,994,-3.761194
22/03/2018 09:29,201801,WESTERN EUROPE-EU,FRANCE,BRISTOL,BORDEAUX,2330,2330,0,1262,1262,0,84.627575
22/03/2018 09:29,201801,WESTERN EUROPE-EU,FRANCE,BRISTOL,CHAMBERY,3008,0,3008,3322,0,3322,-9.452137
22/03/2018 09:29,201801,WESTERN EUROPE-EU,FRANCE,BRISTOL,GRENOBLE,2634,2634,0,2165,2165,0,21.662818
22/03/2018 09:29,201801,WESTERN EUROPE-EU,FRANCE,BRISTOL,LYON,1140,952,188,861,861,0,32.404181
22/03/2018 09:29,201801,WESTERN EUROPE-EU,FRANCE,BRISTOL,MONTPELLIER,41,0,41,0,0,0,0
22/03/2018 09:29,201801,WESTERN EUROPE-EU,FRANCE,BRISTOL,PARIS (CHARLES DE GAULLE),12434,12434,0,11910,11834,76,4.399664
22/03/2018 09:29,201801,WESTERN EUROPE-EU,FRANCE,BRISTOL,TOULOUSE (BLAGNAC),6814,5136,1678,6508,4949,1559,4.701905
22/03/2018 09:29,201801,WESTERN EUROPE-EU,FRANCE,CARDIFF WALES,CHAMBERY,553,553,0,414,414,0,33.574879
22/03/2018 09:29,201801,WESTERN EUROPE-EU,FRANCE,CARDIFF WALES,CLERMONT FERRAND,125,0,125,0,0,0,0
22/03/2018 09:29,201801,WESTERN EUROPE-EU,FRANCE,CARDIFF WALES,LYON,39,0,39,68,0,68,-42.647059
22/03/2018 09:29,201801,WESTERN EUROPE-EU,FRANCE,CARDIFF WALES,LYON(BRON),38,0,38,0,0,0,0
22/03/2018 09:29,201801,WESTERN EUROPE-EU,FRANCE,CARDIFF WALES,PARIS (CHARLES DE GAULLE),4006,4006,0,3823,3811,12,4.786817
22/03/2018 09:29,201801,WESTERN EUROPE-EU,FRANCE,CARDIFF WALES,PAU,0,0,0,116,0,116,-100
22/03/2018 09:29,201801,WESTERN EUROPE-EU,FRANCE,CARDIFF WALES,TOULON / HYERES,208,0,208,0,0,0,0
22/03/2018 09:29,201801,WESTERN EUROPE-EU,FRANCE,CARDIFF WALES,TOULOUSE (BLAGNAC),80,0,80,0,0,0,0
22/03/2018 09:29,201801,WESTERN EUROPE-EU,FRANCE,DONCASTER SHEFFIELD,CHAMBERY,1146,0,1146,382,382,0,200
22/03/2018 09:29,201801,WESTERN EUROPE-EU,FRANCE,DONCASTER SHEFFIELD,PARIS (CHARLES DE GAULLE),2929,2929,0,2227,2227,0,31.522227
22/03/2018 09:29,201801,WESTERN EUROPE-EU,FRANCE,EAST MIDLANDS INTERNATIONAL,CHAMBERY,1410,0,1410,1412,0,1412,-0.141643
22/03/2018 09:29,201801,WESTERN EUROPE-EU,FRANCE,EAST MIDLANDS INTERNATIONAL,LIMOGES,2860,2860,0,3799,3799,0,-24.717031
22/03/2018 09:29,201801,WESTERN EUROPE-EU,FRANCE,EAST MIDLANDS INTERNATIONAL,PARIS (LE BOURGET),93,0,93,0,0,0,0
22/03/2018 09:29,201801,WESTERN EUROPE-EU,FRANCE,EAST MIDLANDS INTERNATIONAL,TOULOUSE (BLAGNAC),100,0,100,0,0,0,0
22/03/2018 09:29,201801,WESTERN EUROPE-EU,FRANCE,EDINBURGH,BERGERAC,0,0,0,106,106,0,-100
22/03/2018 09:29,201801,WESTERN EUROPE-EU,FRANCE,EDINBURGH,BORDEAUX,0,0,0,2456,2456,0,-100
22/03/2018 09:29,201801,WESTERN EUROPE-EU,FRANCE,EDINBURGH,CARCASSONNE,1853,1853,0,0,0,0,0
22/03/2018 09:29,201801,WESTERN EUROPE-EU,FRANCE,EDINBURGH,CHAMBERY,1674,0,1674,1460,0,1460,14.657534
22/03/2018 09:29,201801,WESTERN EUROPE-EU,FRANCE,EDINBURGH,GRENOBLE,1016,1016,0,1034,1034,0,-1.740812
22/03/2018 09:29,201801,WESTERN EUROPE-EU,FRANCE,EDINBURGH,LYON,1314,1314,0,1100,1100,0,19.454545
22/03/2018 09:29,201801,WESTERN EUROPE-EU,FRANCE,EDINBURGH,MARSEILLE,2244,2244,0,0,0,0,0
22/03/2018 09:29,201801,WESTERN EUROPE-EU,FRANCE,EDINBURGH,MONTPELLIER,172,172,0,0,0,0,0
22/03/2018 09:29,201801,WESTERN EUROPE-EU,FRANCE,EDINBURGH,NANTES,2415,2415,0,0,0,0,0
22/03/2018 09:29,201801,WESTERN EUROPE-EU,FRANCE,EDINBURGH,PARIS (CHARLES DE GAULLE),27977,27731,246,23257,23257,0,20.294965
22/03/2018 09:29,201801,WESTERN EUROPE-EU,FRANCE,EDINBURGH,PARIS (ORLY),2890,2890,0,4132,4132,0,-30.058083
22/03/2018 09:29,201801,WESTERN EUROPE-EU,FRANCE,EDINBURGH,TOULOUSE (BLAGNAC),3008,2380,628,693,0,693,334.054834
22/03/2018 09:29,201801,WESTERN EUROPE-EU,FRANCE,EXETER,CHAMBERY,1895,515,1380,601,601,0,215.30782
22/03/2018 09:29,201801,WESTERN EUROPE-EU,FRANCE,EXETER,CLERMONT FERRAND,0,0,0,98,0,98,-100
22/03/2018 09:29,201801,WESTERN EUROPE-EU,FRANCE,EXETER,PARIS (CHARLES DE GAULLE),2610,2610,0,2710,2710,0,-3.690037
22/03/2018 09:29,201801,WESTERN EUROPE-EU,FRANCE,EXETER,TOULOUSE (BLAGNAC),0,0,0,36,36,0,-100
22/03/2018 09:29,201801,WESTERN EUROPE-EU,FRANCE,GLASGOW,CHAMBERY,1686,0,1686,1627,0,1627,3.626306
22/03/2018 09:29,201801,WESTERN EUROPE-EU,FRANCE,GLASGOW,GRENOBLE,1063,1063,0,809,809,0,31.396786
22/03/2018 09:29,201801,WESTERN EUROPE-EU,FRANCE,GLASGOW,LYON,188,0,188,0,0,0,0
22/03/2018 09:29,201801,WESTERN EUROPE-EU,FRANCE,GLASGOW,PARIS (CHARLES DE GAULLE),7210,7210,0,9704,9704,0,-25.700742
22/03/2018 09:29,201801,WESTERN EUROPE-EU,FRANCE,GUERNSEY,DINARD,274,274,0,207,207,0,32.36715
22/03/2018 09:29,201801,WESTERN EUROPE-EU,FRANCE,GUERNSEY,GRENOBLE,0,0,0,244,244,0,-100
22/03/2018 09:29,201801,WESTERN EUROPE-EU,FRANCE,LEEDS BRADFORD,GRENOBLE,844,844,0,613,613,0,37.683524
22/03/2018 09:29,201801,WESTERN EUROPE-EU,FRANCE,LEEDS BRADFORD,PARIS (CHARLES DE GAULLE),3357,3357,0,3034,3034,0,10.646012
22/03/2018 09:29,201801,WESTERN EUROPE-EU,FRANCE,LIVERPOOL (JOHN LENNON),BERGERAC,0,0,0,2129,2129,0,-100
22/03/2018 09:29,201801,WESTERN EUROPE-EU,FRANCE,LIVERPOOL (JOHN LENNON),GRENOBLE,918,918,0,656,656,0,39.939024
22/03/2018 09:29,201801,WESTERN EUROPE-EU,FRANCE,LIVERPOOL (JOHN LENNON),NICE,2972,2972,0,3163,3163,0,-6.038571
22/03/2018 09:29,201801,WESTERN EUROPE-EU,FRANCE,LIVERPOOL (JOHN LENNON),PARIS (CHARLES DE GAULLE),3940,3940,0,4895,4895,0,-19.509704
22/03/2018 09:29,201801,WESTERN EUROPE-EU,FRANCE,MANCHESTER,BEAUVAIS,0,0,0,3909,3909,0,-100
22/03/2018 09:29,201801,WESTERN EUROPE-EU,FRANCE,MANCHESTER,BERGERAC,0,0,0,147,147,0,-100
22/03/2018 09:29,201801,WESTERN EUROPE-EU,FRANCE,MANCHESTER,CARCASSONNE,3471,3471,0,2821,2821,0,23.041475
22/03/2018 09:29,201801,WESTERN EUROPE-EU,FRANCE,MANCHESTER,CHAMBERY,6875,971,5904,4734,858,3876,45.226025
22/03/2018 09:29,201801,WESTERN EUROPE-EU,FRANCE,MANCHESTER,GRENOBLE,6081,4545,1536,8900,7548,1352,-31.674157
22/03/2018 09:29,201801,WESTERN EUROPE-EU,FRANCE,MANCHESTER,LIMOGES,3025,3025,0,2837,2837,0,6.626718
22/03/2018 09:29,201801,WESTERN EUROPE-EU,FRANCE,MANCHESTER,LYON,5065,5065,0,4877,4877,0,3.854829
22/03/2018 09:29,201801,WESTERN EUROPE-EU,FRANCE,MANCHESTER,LYON(BRON),77,0,77,0,0,0,0
22/03/2018 09:29,201801,WESTERN EUROPE-EU,FRANCE,MANCHESTER,MARSEILLE,0,0,0,1478,1478,0,-100
22/03/2018 09:29,201801,WESTERN EUROPE-EU,FRANCE,MANCHESTER,NANTES,272,272,0,221,221,0,23.076923
22/03/2018 09:29,201801,WESTERN EUROPE-EU,FRANCE,MANCHESTER,PARIS (CHARLES DE GAULLE),47618,47618,0,48024,48024,0,-0.845411
22/03/2018 09:29,201801,WESTERN EUROPE-EU,FRANCE,MANCHESTER,RENNES,101,101,0,145,145,0,-30.344828
22/03/2018 09:29,201801,WESTERN EUROPE-EU,FRANCE,MANCHESTER,TOULOUSE (BLAGNAC),4305,2922,1383,3946,2618,1328,9.097821
22/03/2018 09:29,201801,WESTERN EUROPE-EU,FRANCE,NEWCASTLE,GRENOBLE,846,846,0,807,807,0,4.832714
22/03/2018 09:29,201801,WESTERN EUROPE-EU,FRANCE,NEWCASTLE,PARIS (CHARLES DE GAULLE),10465,10465,0,11351,11351,0,-7.80548
22/03/2018 09:29,201801,WESTERN EUROPE-EU,FRANCE,NORWICH,CHAMBERY,0,0,0,318,318,0,-100
22/03/2018 09:29,201801,WESTERN EUROPE-EU,FRANCE,SOUTHAMPTON,BERGERAC,1350,1350,0,1369,1369,0,-1.387874
22/03/2018 09:29,201801,WESTERN EUROPE-EU,FRANCE,SOUTHAMPTON,BORDEAUX,85,85,0,0,0,0,0
22/03/2018 09:29,201801,WESTERN EUROPE-EU,FRANCE,SOUTHAMPTON,CHAMBERY,2227,1454,773,1960,1321,639,13.622449
22/03/2018 09:29,201801,WESTERN EUROPE-EU,FRANCE,SOUTHAMPTON,GRENOBLE,0,0,0,21,21,0,-100
22/03/2018 09:29,201801,WESTERN EUROPE-EU,FRANCE,SOUTHAMPTON,LA ROCHELLE,72,72,0,121,121,0,-40.495868
22/03/2018 09:29,201801,WESTERN EUROPE-EU,FRANCE,SOUTHAMPTON,LIMOGES,93,93,0,270,270,0,-65.555556
22/03/2018 09:29,201801,WESTERN EUROPE-EU,FRANCE,SOUTHAMPTON,LYON,463,463,0,2134,2134,0,-78.303655
22/03/2018 09:29,201801,WESTERN EUROPE-EU,FRANCE,SOUTHAMPTON,NANTES,1156,1156,0,1630,1630,0,-29.079755
22/03/2018 09:29,201801,WESTERN EUROPE-EU,FRANCE,SOUTHAMPTON,PARIS (CHARLES DE GAULLE),5597,5597,0,2080,2080,0,169.086538
22/03/2018 09:29,201801,WESTERN EUROPE-EU,FRANCE,SOUTHAMPTON,PARIS (ORLY),0,0,0,4804,4733,71,-100
22/03/2018 09:29,201801,WESTERN EUROPE-EU,FRANCE,SOUTHAMPTON,RENNES,94,94,0,242,242,0,-61.157025
22/03/2018 09:29,201801,WESTERN EUROPE-EU,GERMANY,GATWICK,BERLIN (SCHONEFELD),28709,28709,0,37065,36785,280,-22.544179
22/03/2018 09:29,201801,WESTERN EUROPE-EU,GERMANY,GATWICK,FRANKFURT MAIN,172,172,0,0,0,0,0
22/03/2018 09:29,201801,WESTERN EUROPE-EU,GERMANY,GATWICK,FRIEDRICHSHAFEN,5230,2977,2253,5134,3355,1779,1.869887
22/03/2018 09:29,201801,WESTERN EUROPE-EU,GERMANY,GATWICK,HAMBURG,9440,9440,0,9533,9533,0,-0.975559
22/03/2018 09:29,201801,WESTERN EUROPE-EU,GERMANY,GATWICK,MUNICH,17081,17081,0,15528,15528,0,10.001288
22/03/2018 09:29,201801,WESTERN EUROPE-EU,GERMANY,GATWICK,NUREMBERG,898,898,0,0,0,0,0
22/03/2018 09:29,201801,WESTERN EUROPE-EU,GERMANY,GATWICK,STUTTGART,6861,6861,0,7072,6892,180,-2.983597
22/03/2018 09:29,201801,WESTERN EUROPE-EU,GERMANY,HEATHROW,BERLIN (TEGEL),51707,51707,0,48208,48208,0,7.258131
22/03/2018 09:29,201801,WESTERN EUROPE-EU,GERMANY,HEATHROW,COLOGNE BONN,12424,12424,0,12739,12739,0,-2.472722
22/03/2018 09:29,201801,WESTERN EUROPE-EU,GERMANY,HEATHROW,DUSSELDORF,53291,53291,0,51225,51225,0,4.033187
22/03/2018 09:29,201801,WESTERN EUROPE-EU,GERMANY,HEATHROW,FRANKFURT MAIN,99231,99231,0,101798,101798,0,-2.521661
22/03/2018 09:29,201801,WESTERN EUROPE-EU,GERMANY,HEATHROW,HAMBURG,39916,39916,0,35470,35470,0,12.534536
22/03/2018 09:29,201801,WESTERN EUROPE-EU,GERMANY,HEATHROW,HANOVER,13687,13687,0,15247,15247,0,-10.231521
22/03/2018 09:29,201801,WESTERN EUROPE-EU,GERMANY,HEATHROW,MUNICH,85217,85217,0,84996,84996,0,0.260012
22/03/2018 09:29,201801,WESTERN EUROPE-EU,GERMANY,HEATHROW,STUTTGART,19872,19872,0,22287,22287,0,-10.835913
22/03/2018 09:29,201801,WESTERN EUROPE-EU,GERMANY,LONDON CITY,BERLIN (TEGEL),7568,7568,0,5718,5624,94,32.35397
22/03/2018 09:29,201801,WESTERN EUROPE-EU,GERMANY,LONDON CITY,BREMEN,0,0,0,487,487,0,-100
22/03/2018 09:29,201801,WESTERN EUROPE-EU,GERMANY,LONDON CITY,DUSSELDORF,9070,9070,0,8180,8180,0,10.880196
22/03/2018 09:29,201801,WESTERN EUROPE-EU,GERMANY,LONDON CITY,FRANKFURT MAIN,16884,16884,0,16363,16363,0,3.184013
22/03/2018 09:29,201801,WESTERN EUROPE-EU,GERMANY,LONDON CITY,HAMBURG,0,0,0,3280,3280,0,-100
22/03/2018 09:29,201801,WESTERN EUROPE-EU,GERMANY,LUTON,BERLIN (SCHONEFELD),10234,10234,0,10339,10339,0,-1.015572
22/03/2018 09:29,201801,WESTERN EUROPE-EU,GERMANY,LUTON,DORTMUND,7031,7031,0,5098,5098,0,37.91683
22/03/2018 09:29,201801,WESTERN EUROPE-EU,GERMANY,LUTON,HAMBURG,3255,3255,0,5645,5645,0,-42.338353
22/03/2018 09:29,201801,WESTERN EUROPE-EU,GERMANY,LUTON,MUNICH,5261,5261,0,5209,5209,0,0.998272
22/03/2018 09:29,201801,WESTERN EUROPE-EU,GERMANY,SOUTHEND,BREMEN,0,0,0,41,41,0,-100
22/03/2018 09:29,201801,WESTERN EUROPE-EU,GERMANY,SOUTHEND,COLOGNE BONN,1054,1054,0,0,0,0,0
22/03/2018 09:29,201801,WESTERN EUROPE-EU,GERMANY,SOUTHEND,DUSSELDORF,93,93,0,0,0,0,0
22/03/2018 09:29,201801,WESTERN EUROPE-EU,GERMANY,SOUTHEND,FRANKFURT MAIN,0,0,0,31,31,0,-100
22/03/2018 09:29,201801,WESTERN EUROPE-EU,GERMANY,STANSTED,BERLIN (SCHONEFELD),33134,33134,0,35501,35501,0,-6.667418
22/03/2018 09:29,201801,WESTERN EUROPE-EU,GERMANY,STANSTED,BERLIN (TEGEL),458,458,0,276,276,0,65.942029
22/03/2018 09:29,201801,WESTERN EUROPE-EU,GERMANY,STANSTED,BREMEN,14655,14655,0,13762,13762,0,6.488882
22/03/2018 09:29,201801,WESTERN EUROPE-EU,GERMANY,STANSTED,COLOGNE BONN,32011,32011,0,31858,31858,0,0.480256
22/03/2018 09:29,201801,WESTERN EUROPE-EU,GERMANY,STANSTED,DORTMUND,8850,8850,0,9124,9124,0,-3.003069
22/03/2018 09:29,201801,WESTERN EUROPE-EU,GERMANY,STANSTED,DUSSELDORF,0,0,0,40,40,0,-100
22/03/2018 09:29,201801,WESTERN EUROPE-EU,GERMANY,STANSTED,FRANKFURT MAIN,17621,17621,0,0,0,0,0
22/03/2018 09:29,201801,WESTERN EUROPE-EU,GERMANY,STANSTED,HAHN,8523,8523,0,9361,9361,0,-8.952035
22/03/2018 09:29,201801,WESTERN EUROPE-EU,GERMANY,STANSTED,HAMBURG,10985,10985,0,17188,17188,0,-36.089132
22/03/2018 09:29,201801,WESTERN EUROPE-EU,GERMANY,STANSTED,HANOVER,5291,5291,0,4515,4515,0,17.187154
22/03/2018 09:29,201801,WESTERN EUROPE-EU,GERMANY,STANSTED,KARLSRUHE/BADEN BADEN,10635,10635,0,7935,7935,0,34.026465
22/03/2018 09:29,201801,WESTERN EUROPE-EU,GERMANY,STANSTED,LEIPZIG,4039,4039,0,3618,3618,0,11.636263
22/03/2018 09:29,201801,WESTERN EUROPE-EU,GERMANY,STANSTED,MEMMINGEN ALLGAU,8633,8633,0,8629,8629,0,0.046355
22/03/2018 09:29,201801,WESTERN EUROPE-EU,GERMANY,STANSTED,MUNICH,10692,10692,0,6742,6348,394,58.587956
22/03/2018 09:29,201801,WESTERN EUROPE-EU,GERMANY,STANSTED,NIEDERRHEIN,2989,2989,0,5467,5467,0,-45.326504
22/03/2018 09:29,201801,WESTERN EUROPE-EU,GERMANY,STANSTED,NUREMBERG,14318,14318,0,13450,13450,0,6.453532
22/03/2018 09:29,201801,WESTERN EUROPE-EU,GERMANY,STANSTED,STUTTGART,6091,6091,0,6454,6454,0,-5.624419
22/03/2018 09:29,201801,WESTERN EUROPE-EU,GERMANY,ABERDEEN,FRANKFURT MAIN,6962,6962,0,7374,7374,0,-5.587198
22/03/2018 09:29,201801,WESTERN EUROPE-EU,GERMANY,BELFAST INTERNATIONAL,BERLIN (SCHONEFELD),2892,2892,0,3749,3749,0,-22.859429
22/03/2018 09:29,201801,WESTERN EUROPE-EU,GERMANY,BIRMINGHAM,BERLIN (TEGEL),5141,5141,0,5325,5325,0,-3.455399
22/03/2018 09:29,201801,WESTERN EUROPE-EU,GERMANY,BIRMINGHAM,DUSSELDORF,18406,18406,0,19821,19821,0,-7.138893
22/03/2018 09:29,201801,WESTERN EUROPE-EU,GERMANY,BIRMINGHAM,FRANKFURT MAIN,19521,19521,0,20091,20091,0,-2.837091
22/03/2018 09:29,201801,WESTERN EUROPE-EU,GERMANY,BIRMINGHAM,HAMBURG,1797,1797,0,1623,1623,0,10.720887
22/03/2018 09:29,201801,WESTERN EUROPE-EU,GERMANY,BIRMINGHAM,HANOVER,2291,2291,0,3033,3033,0,-24.464227
22/03/2018 09:29,201801,WESTERN EUROPE-EU,GERMANY,BIRMINGHAM,MUNICH,15538,15538,0,16909,16510,399,-8.108108
22/03/2018 09:29,201801,WESTERN EUROPE-EU,GERMANY,BIRMINGHAM,PADERBORN,260,260,0,953,598,355,-72.717733
22/03/2018 09:29,201801,WESTERN EUROPE-EU,GERMANY,BIRMINGHAM,STUTTGART,4351,4351,0,3593,3593,0,21.096577
22/03/2018 09:29,201801,WESTERN EUROPE-EU,GERMANY,BRISTOL,BERLIN (SCHONEFELD),5607,5607,0,5701,5701,0,-1.648834
22/03/2018 09:29,201801,WESTERN EUROPE-EU,GERMANY,BRISTOL,COLOGNE BONN,4299,4299,0,0,0,0,0
22/03/2018 09:29,201801,WESTERN EUROPE-EU,GERMANY,BRISTOL,DUSSELDORF,1063,1063,0,934,934,0,13.811563
22/03/2018 09:29,201801,WESTERN EUROPE-EU,GERMANY,BRISTOL,FRANKFURT MAIN,3720,3720,0,3129,3129,0,18.887824
22/03/2018 09:29,201801,WESTERN EUROPE-EU,GERMANY,BRISTOL,HAMBURG,919,919,0,1102,1102,0,-16.606171
22/03/2018 09:29,201801,WESTERN EUROPE-EU,GERMANY,BRISTOL,MUNICH,3100,3100,0,2179,2179,0,42.267095
22/03/2018 09:29,201801,WESTERN EUROPE-EU,GERMANY,CARDIFF WALES,BERLIN (TEGEL),1161,1161,0,594,594,0,95.454545
22/03/2018 09:29,201801,WESTERN EUROPE-EU,GERMANY,CARDIFF WALES,FRANKFURT MAIN,0,0,0,83,43,40,-100
22/03/2018 09:29,201801,WESTERN EUROPE-EU,GERMANY,CARDIFF WALES,MUNICH,1171,1171,0,720,720,0,62.638889
22/03/2018 09:29,201801,WESTERN EUROPE-EU,GERMANY,DONCASTER SHEFFIELD,BERLIN (TEGEL),211,211,0,839,839,0,-74.851013
22/03/2018 09:29,201801,WESTERN EUROPE-EU,GERMANY,DONCASTER SHEFFIELD,DUSSELDORF,0,0,0,1028,1028,0,-100
22/03/2018 09:29,201801,WESTERN EUROPE-EU,GERMANY,EAST MIDLANDS INTERNATIONAL,BERLIN (SCHONEFELD),4490,4490,0,4154,4154,0,8.088589
22/03/2018 09:29,201801,WESTERN EUROPE-EU,GERMANY,EAST MIDLANDS INTERNATIONAL,BREMEN,110,110,0,0,0,0,0
22/03/2018 09:29,201801,WESTERN EUROPE-EU,GERMANY,EDINBURGH,BERLIN (SCHONEFELD),3661,3661,0,2707,2707,0,35.241965
22/03/2018 09:29,201801,WESTERN EUROPE-EU,GERMANY,EDINBURGH,COLOGNE BONN,556,556,0,508,508,0,9.448819
22/03/2018 09:29,201801,WESTERN EUROPE-EU,GERMANY,EDINBURGH,DUSSELDORF,454,454,0,0,0,0,0
22/03/2018 09:29,201801,WESTERN EUROPE-EU,GERMANY,EDINBURGH,FRANKFURT MAIN,7894,7894,0,7934,7934,0,-0.504159
22/03/2018 09:29,201801,WESTERN EUROPE-EU,GERMANY,EDINBURGH,HAMBURG,3344,3344,0,3171,3171,0,5.455692
22/03/2018 09:29,201801,WESTERN EUROPE-EU,GERMANY,EDINBURGH,KARLSRUHE/BADEN BADEN,1576,1576,0,0,0,0,0
22/03/2018 09:29,201801,WESTERN EUROPE-EU,GERMANY,EDINBURGH,MUNICH,6799,6799,0,5001,5001,0,35.952809
22/03/2018 09:29,201801,WESTERN EUROPE-EU,GERMANY,EDINBURGH,NIEDERRHEIN,3725,3725,0,4088,4088,0,-8.879648
22/03/2018 09:29,201801,WESTERN EUROPE-EU,GERMANY,EDINBURGH,STUTTGART,1718,1718,0,2070,2070,0,-17.004831
22/03/2018 09:29,201801,WESTERN EUROPE-EU,GERMANY,GLASGOW,BERLIN (SCHONEFELD),15752,15752,0,15920,15920,0,-1.055276
22/03/2018 09:29,201801,WESTERN EUROPE-EU,GERMANY,GLASGOW,DUSSELDORF,1873,1873,0,2452,2452,0,-23.613377
22/03/2018 09:29,201801,WESTERN EUROPE-EU,GERMANY,GLASGOW,FRANKFURT MAIN,5973,5973,0,0,0,0,0
22/03/2018 09:29,201801,WESTERN EUROPE-EU,GERMANY,GLASGOW,LEIPZIG,0,0,0,606,0,606,-100
22/03/2018 09:29,201801,WESTERN EUROPE-EU,GERMANY,GLASGOW,MUNICH,1924,1924,0,0,0,0,0
22/03/2018 09:29,201801,WESTERN EUROPE-EU,GERMANY,LEEDS BRADFORD,BERLIN (SCHONEFELD),433,433,0,142,142,0,204.929577
22/03/2018 09:29,201801,WESTERN EUROPE-EU,GERMANY,LEEDS BRADFORD,DUSSELDORF,2254,2254,0,2854,2854,0,-21.023125
22/03/2018 09:29,201801,WESTERN EUROPE-EU,GERMANY,LEEDS BRADFORD,FRANKFURT MAIN,47,47,0,0,0,0,0
22/03/2018 09:29,201801,WESTERN EUROPE-EU,GERMANY,LIVERPOOL (JOHN LENNON),BERLIN (SCHONEFELD),3650,3650,0,4356,4356,0,-16.20753
22/03/2018 09:29,201801,WESTERN EUROPE-EU,GERMANY,MANCHESTER,BERLIN (SCHONEFELD),24636,24636,0,21511,21511,0,14.527451
22/03/2018 09:29,201801,WESTERN EUROPE-EU,GERMANY,MANCHESTER,BREMEN,0,0,0,441,441,0,-100
22/03/2018 09:29,201801,WESTERN EUROPE-EU,GERMANY,MANCHESTER,COLOGNE BONN,11308,11308,0,3419,3419,0,230.739982
22/03/2018 09:29,201801,WESTERN EUROPE-EU,GERMANY,MANCHESTER,DUSSELDORF,17016,17016,0,17324,17324,0,-1.77788
22/03/2018 09:29,201801,WESTERN EUROPE-EU,GERMANY,MANCHESTER,FRANKFURT MAIN,37481,37481,0,27453,27453,0,36.527884
22/03/2018 09:29,201801,WESTERN EUROPE-EU,GERMANY,MANCHESTER,HAMBURG,14685,14685,0,16882,16882,0,-13.013861
22/03/2018 09:29,201801,WESTERN EUROPE-EU,GERMANY,MANCHESTER,HANOVER,2632,2632,0,3853,3853,0,-31.689593
22/03/2018 09:29,201801,WESTERN EUROPE-EU,GERMANY,MANCHESTER,MUNICH,24496,24496,0,25433,25061,372,-3.68419
22/03/2018 09:29,201801,WESTERN EUROPE-EU,GERMANY,MANCHESTER,NUREMBERG,6682,6682,0,6796,6796,0,-1.677457
22/03/2018 09:29,201801,WESTERN EUROPE-EU,GERMANY,MANCHESTER,STUTTGART,4618,4618,0,6760,6760,0,-31.686391
22/03/2018 09:29,201801,WESTERN EUROPE-EU,GERMANY,NEWCASTLE,BERLIN (SCHONEFELD),2288,2288,0,2822,2822,0,-18.92275
22/03/2018 09:29,201801,WESTERN EUROPE-EU,GERMANY,NEWCASTLE,DUSSELDORF,2066,2066,0,2616,2616,0,-21.024465
22/03/2018 09:29,201801,WESTERN EUROPE-EU,GERMANY,SOUTHAMPTON,DUSSELDORF,1990,1990,0,2371,2371,0,-16.069169
22/03/2018 09:29,201801,WESTERN EUROPE-EU,GERMANY,SOUTHAMPTON,MUNICH,2001,2001,0,3150,3150,0,-36.47619
22/03/2018 09:29,201801,WESTERN EUROPE-EU,GIBRALTAR,GATWICK,GIBRALTAR,6449,6449,0,10063,10063,0,-35.913743
22/03/2018 09:29,201801,WESTERN EUROPE-EU,GIBRALTAR,HEATHROW,GIBRALTAR,9213,9213,0,7648,7648,0,20.462866
22/03/2018 09:29,201801,WESTERN EUROPE-EU,GIBRALTAR,LUTON,GIBRALTAR,0,0,0,4192,4192,0,-100
22/03/2018 09:29,201801,WESTERN EUROPE-EU,GIBRALTAR,BIRMINGHAM,GIBRALTAR,0,0,0,931,931,0,-100
22/03/2018 09:29,201801,WESTERN EUROPE-EU,GIBRALTAR,BRISTOL,GIBRALTAR,2694,2694,0,2584,2584,0,4.256966
22/03/2018 09:29,201801,WESTERN EUROPE-EU,GIBRALTAR,MANCHESTER,GIBRALTAR,2837,2837,0,6695,6695,0,-57.625093
22/03/2018 09:29,201801,WESTERN EUROPE-EU,GREECE,GATWICK,ATHENS,12388,12388,0,11963,11963,0,3.552621
22/03/2018 09:29,201801,WESTERN EUROPE-EU,GREECE,GATWICK,KAVALA,3801,3801,0,0,0,0,0
22/03/2018 09:29,201801,WESTERN EUROPE-EU,GREECE,GATWICK,SALONIKA,0,0,0,5760,5760,0,-100
22/03/2018 09:29,201801,WESTERN EUROPE-EU,GREECE,HEATHROW,ATHENS,47875,47875,0,49439,49439,0,-3.163494
22/03/2018 09:29,201801,WESTERN EUROPE-EU,GREECE,LUTON,ATHENS,0,0,0,11,0,11,-100
22/03/2018 09:29,201801,WESTERN EUROPE-EU,GREECE,STANSTED,ATHENS,17023,17023,0,17421,17421,0,-2.284599
22/03/2018 09:29,201801,WESTERN EUROPE-EU,GREECE,STANSTED,KAVALA,182,182,0,0,0,0,0
22/03/2018 09:29,201801,WESTERN EUROPE-EU,GREECE,STANSTED,SALONIKA,8408,8408,0,8525,8525,0,-1.372434
22/03/2018 09:29,201801,WESTERN EUROPE-EU,GREECE,BRISTOL,ATHENS,2671,2671,0,0,0,0,0
22/03/2018 09:29,201801,WESTERN EUROPE-EU,GREECE,EDINBURGH,ATHENS,3808,3808,0,2770,2770,0,37.472924
22/03/2018 09:29,201801,WESTERN EUROPE-EU,GREECE,MANCHESTER,ATHENS,6661,6661,0,7080,7080,0,-5.918079
22/03/2018 09:29,201801,WESTERN EUROPE-EU,GREECE,MANCHESTER,KAVALA,2171,2171,0,0,0,0,0
22/03/2018 09:29,201801,WESTERN EUROPE-EU,GREECE,MANCHESTER,SALONIKA,0,0,0,681,681,0,-100
22/03/2018 09:29,201801,WESTERN EUROPE-EU,IRISH REPUBLIC,GATWICK,CORK,9744,9744,0,9273,9273,0,5.079262
22/03/2018 09:29,201801,WESTERN EUROPE-EU,IRISH REPUBLIC,GATWICK,DUBLIN,110878,110878,0,108009,108009,0,2.65626
22/03/2018 09:29,201801,WESTERN EUROPE-EU,IRISH REPUBLIC,GATWICK,IRELAND WEST(KNOCK),4696,4696,0,3615,3615,0,29.903181
22/03/2018 09:29,201801,WESTERN EUROPE-EU,IRISH REPUBLIC,GATWICK,SHANNON,7861,7861,0,7415,7415,0,6.014835
22/03/2018 09:29,201801,WESTERN EUROPE-EU,IRISH REPUBLIC,HEATHROW,CORK,27045,27045,0,27299,27299,0,-0.930437
22/03/2018 09:29,201801,WESTERN EUROPE-EU,IRISH REPUBLIC,HEATHROW,DUBLIN,119039,119039,0,120509,120509,0,-1.219826
22/03/2018 09:29,201801,WESTERN EUROPE-EU,IRISH REPUBLIC,HEATHROW,SHANNON,18185,18185,0,17404,17404,0,4.487474
22/03/2018 09:29,201801,WESTERN EUROPE-EU,IRISH REPUBLIC,LONDON CITY,DUBLIN,34491,34491,0,30851,30851,0,11.798645
22/03/2018 09:29,201801,WESTERN EUROPE-EU,IRISH REPUBLIC,LUTON,DUBLIN,28123,28123,0,27356,27356,0,2.803772
22/03/2018 09:29,201801,WESTERN EUROPE-EU,IRISH REPUBLIC,LUTON,IRELAND WEST(KNOCK),7796,7796,0,8449,8449,0,-7.728725
22/03/2018 09:29,201801,WESTERN EUROPE-EU,IRISH REPUBLIC,LUTON,KERRY COUNTY,7540,7540,0,7939,7939,0,-5.025822
22/03/2018 09:29,201801,WESTERN EUROPE-EU,IRISH REPUBLIC,SOUTHEND,DUBLIN,4768,4768,0,275,275,0,1633.818182
22/03/2018 09:29,201801,WESTERN EUROPE-EU,IRISH REPUBLIC,STANSTED,CORK,26409,26409,0,25829,25829,0,2.245538
22/03/2018 09:29,201801,WESTERN EUROPE-EU,IRISH REPUBLIC,STANSTED,DUBLIN,70711,70711,0,68579,68579,0,3.108823
22/03/2018 09:29,201801,WESTERN EUROPE-EU,IRISH REPUBLIC,STANSTED,IRELAND WEST(KNOCK),11251,11251,0,10879,10879,0,3.419432
22/03/2018 09:29,201801,WESTERN EUROPE-EU,IRISH REPUBLIC,STANSTED,KERRY COUNTY,5130,5130,0,4748,4748,0,8.045493
22/03/2018 09:29,201801,WESTERN EUROPE-EU,IRISH REPUBLIC,STANSTED,SHANNON,15559,15559,0,15455,15455,0,0.672921
22/03/2018 09:29,201801,WESTERN EUROPE-EU,IRISH REPUBLIC,ABERDEEN,DUBLIN,3372,3372,0,2533,2533,0,33.122779
22/03/2018 09:29,201801,WESTERN EUROPE-EU,IRISH REPUBLIC,BIRMINGHAM,CORK,5262,5262,0,5189,5189,0,1.406822
22/03/2018 09:29,201801,WESTERN EUROPE-EU,IRISH REPUBLIC,BIRMINGHAM,DUBLIN,68502,68502,0,70580,70580,0,-2.944177
22/03/2018 09:29,201801,WESTERN EUROPE-EU,IRISH REPUBLIC,BIRMINGHAM,IRELAND WEST(KNOCK),1301,1301,0,1235,1235,0,5.34413
22/03/2018 09:29,201801,WESTERN EUROPE-EU,IRISH REPUBLIC,BIRMINGHAM,SHANNON,2782,2782,0,2408,2408,0,15.531561
22/03/2018 09:29,201801,WESTERN EUROPE-EU,IRISH REPUBLIC,BRISTOL,CORK,2456,2456,0,2613,2613,0,-6.008419
22/03/2018 09:29,201801,WESTERN EUROPE-EU,IRISH REPUBLIC,BRISTOL,DUBLIN,31410,31410,0,31066,30998,68,1.10732
22/03/2018 09:29,201801,WESTERN EUROPE-EU,IRISH REPUBLIC,CARDIFF WALES,CORK,789,789,0,811,811,0,-2.7127
22/03/2018 09:29,201801,WESTERN EUROPE-EU,IRISH REPUBLIC,CARDIFF WALES,DUBLIN,6882,6846,36,6094,6094,0,12.930752
22/03/2018 09:29,201801,WESTERN EUROPE-EU,IRISH REPUBLIC,CITY OF DERRY (EGLINTON),DUBLIN,13,13,0,0,0,0,0
22/03/2018 09:29,201801,WESTERN EUROPE-EU,IRISH REPUBLIC,DONCASTER SHEFFIELD,DUBLIN,1445,1348,97,1297,1297,0,11.410948
22/03/2018 09:29,201801,WESTERN EUROPE-EU,IRISH REPUBLIC,EAST MIDLANDS INTERNATIONAL,DUBLIN,17008,17008,0,16871,16871,0,0.812044
22/03/2018 09:29,201801,WESTERN EUROPE-EU,IRISH REPUBLIC,EAST MIDLANDS INTERNATIONAL,IRELAND WEST(KNOCK),4214,4214,0,4165,4165,0,1.176471
22/03/2018 09:29,201801,WESTERN EUROPE-EU,IRISH REPUBLIC,EDINBURGH,CORK,3153,3153,0,2361,2361,0,33.545108
22/03/2018 09:29,201801,WESTERN EUROPE-EU,IRISH REPUBLIC,EDINBURGH,DUBLIN,44366,44366,0,43683,43683,0,1.563537
22/03/2018 09:29,201801,WESTERN EUROPE-EU,IRISH REPUBLIC,EDINBURGH,IRELAND WEST(KNOCK),1343,1343,0,1225,1225,0,9.632653
22/03/2018 09:29,201801,WESTERN EUROPE-EU,IRISH REPUBLIC,EDINBURGH,SHANNON,1552,1552,0,1550,1550,0,0.129032
22/03/2018 09:29,201801,WESTERN EUROPE-EU,IRISH REPUBLIC,EXETER,DUBLIN,1738,1738,0,1576,1576,0,10.279188
22/03/2018 09:29,201801,WESTERN EUROPE-EU,IRISH REPUBLIC,GLASGOW,CORK,1472,1472,0,1499,1499,0,-1.801201
22/03/2018 09:29,201801,WESTERN EUROPE-EU,IRISH REPUBLIC,GLASGOW,DONEGAL,446,446,0,435,435,0,2.528736
22/03/2018 09:29,201801,WESTERN EUROPE-EU,IRISH REPUBLIC,GLASGOW,DUBLIN,36117,36117,0,36866,36866,0,-2.031682
22/03/2018 09:29,201801,WESTERN EUROPE-EU,IRISH REPUBLIC,GLASGOW,SHANNON,0,0,0,189,0,189,-100
22/03/2018 09:29,201801,WESTERN EUROPE-EU,IRISH REPUBLIC,INVERNESS,DUBLIN,618,618,0,661,661,0,-6.505295
22/03/2018 09:29,201801,WESTERN EUROPE-EU,IRISH REPUBLIC,ISLE OF MAN,DUBLIN,3050,3050,0,2772,2772,0,10.02886
22/03/2018 09:29,201801,WESTERN EUROPE-EU,IRISH REPUBLIC,LEEDS BRADFORD,DUBLIN,22708,22708,0,22197,22197,0,2.302113
22/03/2018 09:29,201801,WESTERN EUROPE-EU,IRISH REPUBLIC,LIVERPOOL (JOHN LENNON),CORK,6741,6741,0,6820,6820,0,-1.158358
22/03/2018 09:29,201801,WESTERN EUROPE-EU,IRISH REPUBLIC,LIVERPOOL (JOHN LENNON),DUBLIN,31662,31662,0,36405,36405,0,-13.02843
22/03/2018 09:29,201801,WESTERN EUROPE-EU,IRISH REPUBLIC,LIVERPOOL (JOHN LENNON),IRELAND WEST(KNOCK),6751,6751,0,7005,7005,0,-3.625981
22/03/2018 09:29,201801,WESTERN EUROPE-EU,IRISH REPUBLIC,MANCHESTER,CORK,7192,7192,0,6882,6882,0,4.504505
22/03/2018 09:29,201801,WESTERN EUROPE-EU,IRISH REPUBLIC,MANCHESTER,DUBLIN,78561,78561,0,81019,80728,291,-3.033856
22/03/2018 09:29,201801,WESTERN EUROPE-EU,IRISH REPUBLIC,MANCHESTER,IRELAND WEST(KNOCK),1527,1527,0,1638,1638,0,-6.776557
22/03/2018 09:29,201801,WESTERN EUROPE-EU,IRISH REPUBLIC,MANCHESTER,SHANNON,6306,6306,0,5862,5862,0,7.574207
22/03/2018 09:29,201801,WESTERN EUROPE-EU,IRISH REPUBLIC,NEWCASTLE,CORK,659,659,0,839,839,0,-21.454112
22/03/2018 09:29,201801,WESTERN EUROPE-EU,IRISH REPUBLIC,NEWCASTLE,DUBLIN,18835,18772,63,20922,20921,1,-9.975146
22/03/2018 09:29,201801,WESTERN EUROPE-EU,IRISH REPUBLIC,NEWQUAY,DUBLIN,1146,1146,0,1054,1054,0,8.728653
22/03/2018 09:29,201801,WESTERN EUROPE-EU,IRISH REPUBLIC,SOUTHAMPTON,CORK,1059,1059,0,889,889,0,19.12261
22/03/2018 09:29,201801,WESTERN EUROPE-EU,IRISH REPUBLIC,SOUTHAMPTON,DUBLIN,9304,9304,0,9447,9447,0,-1.513708
22/03/2018 09:29,201801,WESTERN EUROPE-EU,ITALY,GATWICK,ANCONA,178,178,0,0,0,0,0
22/03/2018 09:29,201801,WESTERN EUROPE-EU,ITALY,GATWICK,BOLOGNA,5674,5674,0,5740,5740,0,-1.149826
22/03/2018 09:29,201801,WESTERN EUROPE-EU,ITALY,GATWICK,CATANIA (FONTANAROSSA),3605,3605,0,2921,2921,0,23.416638
22/03/2018 09:29,201801,WESTERN EUROPE-EU,ITALY,GATWICK,FLORENCE,7613,7613,0,7083,7083,0,7.482705
22/03/2018 09:29,201801,WESTERN EUROPE-EU,ITALY,GATWICK,GENOA,3027,3027,0,3042,3042,0,-0.493097
22/03/2018 09:29,201801,WESTERN EUROPE-EU,ITALY,GATWICK,MILAN (LINATE),22373,22373,0,23011,23011,0,-2.772587
22/03/2018 09:29,201801,WESTERN EUROPE-EU,ITALY,GATWICK,MILAN (MALPENSA),38973,38854,119,38967,38967,0,0.015398
22/03/2018 09:29,201801,WESTERN EUROPE-EU,ITALY,GATWICK,NAPLES,15540,15540,0,13224,13224,0,17.513612
22/03/2018 09:29,201801,WESTERN EUROPE-EU,ITALY,GATWICK,OLBIA,2302,2302,0,0,0,0,0
22/03/2018 09:29,201801,WESTERN EUROPE-EU,ITALY,GATWICK,PALERMO,2545,2545,0,2491,2491,0,2.167804
22/03/2018 09:29,201801,WESTERN EUROPE-EU,ITALY,GATWICK,PISA,8724,8724,0,6741,6741,0,29.417
22/03/2018 09:29,201801,WESTERN EUROPE-EU,ITALY,GATWICK,ROME (FIUMICINO),42204,42204,0,45536,45536,0,-7.317287
22/03/2018 09:29,201801,WESTERN EUROPE-EU,ITALY,GATWICK,TURIN,22600,17643,4957,24196,18741,5455,-6.596132
22/03/2018 09:29,201801,WESTERN EUROPE-EU,ITALY,GATWICK,VENICE,37058,37058,0,41036,41036,0,-9.693927
22/03/2018 09:29,201801,WESTERN EUROPE-EU,ITALY,GATWICK,VERONA VILLAFRANCA,12493,10927,1566,13141,11725,1416,-4.931132
22/03/2018 09:29,201801,WESTERN EUROPE-EU,ITALY,HEATHROW,BOLOGNA,18726,18726,0,17859,17859,0,4.854695
22/03/2018 09:29,201801,WESTERN EUROPE-EU,ITALY,HEATHROW,MILAN (LINATE),48268,48268,0,48453,48453,0,-0.381813
22/03/2018 09:29,201801,WESTERN EUROPE-EU,ITALY,HEATHROW,MILAN (MALPENSA),11156,11156,0,12125,12125,0,-7.991753
22/03/2018 09:29,201801,WESTERN EUROPE-EU,ITALY,HEATHROW,PALERMO,1543,1543,0,0,0,0,0
22/03/2018 09:29,201801,WESTERN EUROPE-EU,ITALY,HEATHROW,PISA,4482,4482,0,6308,6308,0,-28.947368
22/03/2018 09:29,201801,WESTERN EUROPE-EU,ITALY,HEATHROW,ROME (FIUMICINO),60064,60064,0,58465,58465,0,2.73497
22/03/2018 09:29,201801,WESTERN EUROPE-EU,ITALY,HEATHROW,TURIN,1681,1681,0,0,0,0,0
22/03/2018 09:29,201801,WESTERN EUROPE-EU,ITALY,HEATHROW,VENICE,12892,12892,0,12226,12226,0,5.447407
22/03/2018 09:29,201801,WESTERN EUROPE-EU,ITALY,LONDON CITY,BOLOGNA,0,0,0,85,85,0,-100
22/03/2018 09:29,201801,WESTERN EUROPE-EU,ITALY,LONDON CITY,FLORENCE,4346,4346,0,5835,5835,0,-25.518423
22/03/2018 09:29,201801,WESTERN EUROPE-EU,ITALY,LONDON CITY,MILAN (LINATE),20809,20809,0,13267,13267,0,56.847818
22/03/2018 09:29,201801,WESTERN EUROPE-EU,ITALY,LONDON CITY,ROME (FIUMICINO),3161,3161,0,3716,3716,0,-14.935414
22/03/2018 09:29,201801,WESTERN EUROPE-EU,ITALY,LUTON,ALGHERO (FERTILIA),2101,2101,0,0,0,0,0
22/03/2018 09:29,201801,WESTERN EUROPE-EU,ITALY,LUTON,CAGLIARI (ELMAS),0,0,0,2565,2565,0,-100
22/03/2018 09:29,201801,WESTERN EUROPE-EU,ITALY,LUTON,CATANIA (FONTANAROSSA),3201,3201,0,2698,2698,0,18.64344
22/03/2018 09:29,201801,WESTERN EUROPE-EU,ITALY,LUTON,FLORENCE,1296,1296,0,0,0,0,0
22/03/2018 09:29,201801,WESTERN EUROPE-EU,ITALY,LUTON,MILAN (MALPENSA),10714,10714,0,7256,7256,0,47.657111
22/03/2018 09:29,201801,WESTERN EUROPE-EU,ITALY,LUTON,NAPLES,6668,6668,0,5474,5474,0,21.812203
22/03/2018 09:29,201801,WESTERN EUROPE-EU,ITALY,LUTON,PALERMO,0,0,0,182,182,0,-100
22/03/2018 09:29,201801,WESTERN EUROPE-EU,ITALY,LUTON,PISA,2126,2126,0,0,0,0,0
22/03/2018 09:29,201801,WESTERN EUROPE-EU,ITALY,LUTON,ROME (FIUMICINO),6204,6204,0,8012,8012,0,-22.566151
22/03/2018 09:29,201801,WESTERN EUROPE-EU,ITALY,LUTON,TURIN,3004,3004,0,3501,3501,0,-14.195944
22/03/2018 09:29,201801,WESTERN EUROPE-EU,ITALY,LUTON,VENICE,3057,3057,0,3930,3930,0,-22.21374
22/03/2018 09:29,201801,WESTERN EUROPE-EU,ITALY,SOUTHEND,FLORENCE,0,0,0,50,50,0,-100
22/03/2018 09:29,201801,WESTERN EUROPE-EU,ITALY,SOUTHEND,MILAN (LINATE),43,43,0,0,0,0,0
22/03/2018 09:29,201801,WESTERN EUROPE-EU,ITALY,STANSTED,ANCONA,6390,6390,0,6777,6777,0,-5.710491
22/03/2018 09:29,201801,WESTERN EUROPE-EU,ITALY,STANSTED,BARI (PALESE),11411,11411,0,10569,10569,0,7.966695
22/03/2018 09:29,201801,WESTERN EUROPE-EU,ITALY,STANSTED,BERGAMO,33688,33688,0,38942,38942,0,-13.49186
22/03/2018 09:29,201801,WESTERN EUROPE-EU,ITALY,STANSTED,BOLOGNA,20101,20101,0,19030,19030,0,5.627956
22/03/2018 09:29,201801,WESTERN EUROPE-EU,ITALY,STANSTED,BRINDISI,5212,5212,0,4770,4770,0,9.266247
22/03/2018 09:29,201801,WESTERN EUROPE-EU,ITALY,STANSTED,CAGLIARI (ELMAS),7800,7800,0,4044,4044,0,92.878338
22/03/2018 09:29,201801,WESTERN EUROPE-EU,ITALY,STANSTED,FLORENCE,0,0,0,110,110,0,-100
22/03/2018 09:29,201801,WESTERN EUROPE-EU,ITALY,STANSTED,GENOA,4319,4319,0,4304,4304,0,0.348513
22/03/2018 09:29,201801,WESTERN EUROPE-EU,ITALY,STANSTED,LAMETIA-TERME,3519,3519,0,3777,3777,0,-6.830818
22/03/2018 09:29,201801,WESTERN EUROPE-EU,ITALY,STANSTED,MILAN (LINATE),700,700,0,2,2,0,34900
22/03/2018 09:29,201801,WESTERN EUROPE-EU,ITALY,STANSTED,MILAN (MALPENSA),11056,11056,0,19758,19758,0,-44.042919
22/03/2018 09:29,201801,WESTERN EUROPE-EU,ITALY,STANSTED,NAPLES,16714,16714,0,5517,5517,0,202.954504
22/03/2018 09:29,201801,WESTERN EUROPE-EU,ITALY,STANSTED,PALERMO,8004,8004,0,7193,7193,0,11.274851
22/03/2018 09:29,201801,WESTERN EUROPE-EU,ITALY,STANSTED,PERUGIA,5157,5157,0,4949,4949,0,4.202869
22/03/2018 09:29,201801,WESTERN EUROPE-EU,ITALY,STANSTED,PESCARA,7169,7169,0,7152,7152,0,0.237696
22/03/2018 09:29,201801,WESTERN EUROPE-EU,ITALY,STANSTED,PISA,15025,15025,0,22033,22033,0,-31.806835
22/03/2018 09:29,201801,WESTERN EUROPE-EU,ITALY,STANSTED,ROME (CIAMPINO),48566,48566,0,50694,50694,0,-4.197735
22/03/2018 09:29,201801,WESTERN EUROPE-EU,ITALY,STANSTED,ROME (FIUMICINO),0,0,0,38,38,0,-100
22/03/2018 09:29,201801,WESTERN EUROPE-EU,ITALY,STANSTED,TREVISO,26863,26863,0,28171,28171,0,-4.643073
22/03/2018 09:29,201801,WESTERN EUROPE-EU,ITALY,STANSTED,TRIESTE (RONCHI DEI LEGIONARI),4619,4619,0,5426,5426,0,-14.872835
22/03/2018 09:29,201801,WESTERN EUROPE-EU,ITALY,STANSTED,TURIN,11203,10029,1174,12045,10331,1714,-6.990452
22/03/2018 09:29,201801,WESTERN EUROPE-EU,ITALY,STANSTED,VERONA VILLAFRANCA,3901,3901,0,4082,4082,0,-4.434101
22/03/2018 09:29,201801,WESTERN EUROPE-EU,ITALY,BELFAST INTERNATIONAL,BERGAMO,2294,2294,0,2166,2166,0,5.909511
22/03/2018 09:29,201801,WESTERN EUROPE-EU,ITALY,BELFAST INTERNATIONAL,VERONA VILLAFRANCA,1103,0,1103,0,0,0,0
22/03/2018 09:29,201801,WESTERN EUROPE-EU,ITALY,BIRMINGHAM,MILAN (MALPENSA),3447,3447,0,5399,5399,0,-36.154843
22/03/2018 09:29,201801,WESTERN EUROPE-EU,ITALY,BIRMINGHAM,PARMA,0,0,0,187,0,187,-100
22/03/2018 09:29,201801,WESTERN EUROPE-EU,ITALY,BIRMINGHAM,ROME (CIAMPINO),181,181,0,0,0,0,0
22/03/2018 09:29,201801,WESTERN EUROPE-EU,ITALY,BIRMINGHAM,ROME (FIUMICINO),304,304,0,3065,3065,0,-90.081566
22/03/2018 09:29,201801,WESTERN EUROPE-EU,ITALY,BIRMINGHAM,TREVISO,42,0,42,0,0,0,0
22/03/2018 09:29,201801,WESTERN EUROPE-EU,ITALY,BIRMINGHAM,TURIN,3643,2092,1551,3630,987,2643,0.358127
22/03/2018 09:29,201801,WESTERN EUROPE-EU,ITALY,BIRMINGHAM,VERONA VILLAFRANCA,4008,2892,1116,4133,2832,1301,-3.024437
22/03/2018 09:29,201801,WESTERN EUROPE-EU,ITALY,BOURNEMOUTH,TURIN,981,140,841,1385,0,1385,-29.169675
22/03/2018 09:29,201801,WESTERN EUROPE-EU,ITALY,BRISTOL,BERGAMO,3773,3773,0,3634,3634,0,3.824986
22/03/2018 09:29,201801,WESTERN EUROPE-EU,ITALY,BRISTOL,MILAN (MALPENSA),560,560,0,439,439,0,27.562642
22/03/2018 09:29,201801,WESTERN EUROPE-EU,ITALY,BRISTOL,PISA,2192,2192,0,2143,2143,0,2.286514
22/03/2018 09:29,201801,WESTERN EUROPE-EU,ITALY,BRISTOL,ROME (FIUMICINO),5854,5854,0,6969,6969,0,-15.999426
22/03/2018 09:29,201801,WESTERN EUROPE-EU,ITALY,BRISTOL,TURIN,2536,940,1596,2717,743,1974,-6.661759
22/03/2018 09:29,201801,WESTERN EUROPE-EU,ITALY,BRISTOL,VENICE,10109,10109,0,6586,6586,0,53.492256
22/03/2018 09:29,201801,WESTERN EUROPE-EU,ITALY,BRISTOL,VERONA VILLAFRANCA,1493,0,1493,0,0,0,0
22/03/2018 09:29,201801,WESTERN EUROPE-EU,ITALY,CARDIFF WALES,MILAN (MALPENSA),1147,1147,0,1580,1580,0,-27.405063
22/03/2018 09:29,201801,WESTERN EUROPE-EU,ITALY,CARDIFF WALES,ROME (FIUMICINO),1344,1344,0,0,0,0,0
22/03/2018 09:29,201801,WESTERN EUROPE-EU,ITALY,CARDIFF WALES,VENICE,27,27,0,0,0,0,0
22/03/2018 09:29,201801,WESTERN EUROPE-EU,ITALY,DONCASTER SHEFFIELD,TURIN,1171,0,1171,1375,0,1375,-14.836364
22/03/2018 09:29,201801,WESTERN EUROPE-EU,ITALY,EAST MIDLANDS INTERNATIONAL,BERGAMO,4014,4014,0,4370,4370,0,-8.146453
22/03/2018 09:29,201801,WESTERN EUROPE-EU,ITALY,EAST MIDLANDS INTERNATIONAL,ROME (CIAMPINO),0,0,0,5172,5172,0,-100
22/03/2018 09:29,201801,WESTERN EUROPE-EU,ITALY,EAST MIDLANDS INTERNATIONAL,TREVISO,2747,2747,0,2851,2851,0,-3.647843
22/03/2018 09:29,201801,WESTERN EUROPE-EU,ITALY,EDINBURGH,BERGAMO,6652,6652,0,0,0,0,0
22/03/2018 09:29,201801,WESTERN EUROPE-EU,ITALY,EDINBURGH,BOLOGNA,2930,2930,0,2835,2835,0,3.35097
22/03/2018 09:29,201801,WESTERN EUROPE-EU,ITALY,EDINBURGH,MILAN (MALPENSA),8502,8502,0,7302,7302,0,16.433854
22/03/2018 09:29,201801,WESTERN EUROPE-EU,ITALY,EDINBURGH,ROME (CIAMPINO),6224,6224,0,7248,7248,0,-14.128035
22/03/2018 09:29,201801,WESTERN EUROPE-EU,ITALY,EDINBURGH,ROME (FIUMICINO),0,0,0,269,269,0,-100
22/03/2018 09:29,201801,WESTERN EUROPE-EU,ITALY,EDINBURGH,TREVISO,4047,4047,0,0,0,0,0
22/03/2018 09:29,201801,WESTERN EUROPE-EU,ITALY,EDINBURGH,TURIN,1030,1030,0,990,990,0,4.040404
22/03/2018 09:29,201801,WESTERN EUROPE-EU,ITALY,EDINBURGH,VENICE,3267,3267,0,4574,4574,0,-28.574552
22/03/2018 09:29,201801,WESTERN EUROPE-EU,ITALY,EDINBURGH,VERONA VILLAFRANCA,647,0,647,994,994,0,-34.909457
22/03/2018 09:29,201801,WESTERN EUROPE-EU,ITALY,GLASGOW,MILAN (MALPENSA),2263,2263,0,2662,2662,0,-14.98873
22/03/2018 09:29,201801,WESTERN EUROPE-EU,ITALY,GLASGOW,TURIN,1523,0,1523,1742,0,1742,-12.571757
22/03/2018 09:29,201801,WESTERN EUROPE-EU,ITALY,LIVERPOOL (JOHN LENNON),BERGAMO,1865,1865,0,0,0,0,0
22/03/2018 09:29,201801,WESTERN EUROPE-EU,ITALY,LIVERPOOL (JOHN LENNON),MILAN (MALPENSA),3347,3347,0,0,0,0,0
22/03/2018 09:29,201801,WESTERN EUROPE-EU,ITALY,LIVERPOOL (JOHN LENNON),PISA,0,0,0,2589,2589,0,-100
22/03/2018 09:29,201801,WESTERN EUROPE-EU,ITALY,LIVERPOOL (JOHN LENNON),ROME (FIUMICINO),4704,4704,0,0,0,0,0
22/03/2018 09:29,201801,WESTERN EUROPE-EU,ITALY,LIVERPOOL (JOHN LENNON),VENICE,1894,1894,0,0,0,0,0
22/03/2018 09:29,201801,WESTERN EUROPE-EU,ITALY,MANCHESTER,BERGAMO,10414,10414,0,13393,13393,0,-22.242963
22/03/2018 09:29,201801,WESTERN EUROPE-EU,ITALY,MANCHESTER,CATANIA (FONTANAROSSA),2524,2524,0,2099,2099,0,20.247737
22/03/2018 09:29,201801,WESTERN EUROPE-EU,ITALY,MANCHESTER,MILAN (MALPENSA),8752,8752,0,10179,10179,0,-14.019059
22/03/2018 09:29,201801,WESTERN EUROPE-EU,ITALY,MANCHESTER,NAPLES,2959,2959,0,0,0,0,0
22/03/2018 09:29,201801,WESTERN EUROPE-EU,ITALY,MANCHESTER,PISA,2482,2482,0,1911,1911,0,29.879644
22/03/2018 09:29,201801,WESTERN EUROPE-EU,ITALY,MANCHESTER,ROME (CIAMPINO),11787,11787,0,13615,13615,0,-13.426368
22/03/2018 09:29,201801,WESTERN EUROPE-EU,ITALY,MANCHESTER,ROME (FIUMICINO),5024,5024,0,5021,5021,0,0.059749
22/03/2018 09:29,201801,WESTERN EUROPE-EU,ITALY,MANCHESTER,TURIN,7726,4843,2883,9217,5145,4072,-16.17663
22/03/2018 09:29,201801,WESTERN EUROPE-EU,ITALY,MANCHESTER,VENICE,5415,5415,0,7690,7690,0,-29.583875
22/03/2018 09:29,201801,WESTERN EUROPE-EU,ITALY,MANCHESTER,VERONA VILLAFRANCA,1572,0,1572,1434,0,1434,9.623431
22/03/2018 09:29,201801,WESTERN EUROPE-EU,ITALY,NEWCASTLE,TURIN,1297,1297,0,1592,1592,0,-18.530151
22/03/2018 09:29,201801,WESTERN EUROPE-EU,LUXEMBOURG,GATWICK,LUXEMBOURG,4674,4674,0,4858,4858,0,-3.787567
22/03/2018 09:29,201801,WESTERN EUROPE-EU,LUXEMBOURG,HEATHROW,LUXEMBOURG,11643,11643,0,10556,10556,0,10.297461
22/03/2018 09:29,201801,WESTERN EUROPE-EU,LUXEMBOURG,LONDON CITY,LUXEMBOURG,12522,12522,0,11554,11554,0,8.378051
22/03/2018 09:29,201801,WESTERN EUROPE-EU,LUXEMBOURG,STANSTED,LUXEMBOURG,8418,8418,0,8577,8577,0,-1.853795
22/03/2018 09:29,201801,WESTERN EUROPE-EU,LUXEMBOURG,BIRMINGHAM,LUXEMBOURG,0,0,0,1297,1297,0,-100
22/03/2018 09:29,201801,WESTERN EUROPE-EU,LUXEMBOURG,MANCHESTER,LUXEMBOURG,1834,1834,0,2021,2021,0,-9.252845
22/03/2018 09:29,201801,WESTERN EUROPE-EU,MALTA,GATWICK,MALTA,17452,16912,540,17818,16288,1530,-2.054103
22/03/2018 09:29,201801,WESTERN EUROPE-EU,MALTA,HEATHROW,MALTA,14050,14050,0,12325,12325,0,13.995943
22/03/2018 09:29,201801,WESTERN EUROPE-EU,MALTA,LUTON,MALTA,6179,6179,0,6239,6235,4,-0.961693
22/03/2018 09:29,201801,WESTERN EUROPE-EU,MALTA,SOUTHEND,MALTA,2110,2110,0,0,0,0,0
22/03/2018 09:29,201801,WESTERN EUROPE-EU,MALTA,STANSTED,MALTA,5700,5700,0,5099,5099,0,11.786625
22/03/2018 09:29,201801,WESTERN EUROPE-EU,MALTA,BELFAST INTERNATIONAL,MALTA,2455,2455,0,0,0,0,0
22/03/2018 09:29,201801,WESTERN EUROPE-EU,MALTA,BIRMINGHAM,MALTA,4769,4769,0,4092,4092,0,16.544477
22/03/2018 09:29,201801,WESTERN EUROPE-EU,MALTA,BOURNEMOUTH,MALTA,2152,2152,0,2166,2166,0,-0.646353
22/03/2018 09:29,201801,WESTERN EUROPE-EU,MALTA,BRISTOL,MALTA,2897,2897,0,3516,3516,0,-17.605233
22/03/2018 09:29,201801,WESTERN EUROPE-EU,MALTA,EAST MIDLANDS INTERNATIONAL,MALTA,3917,3917,0,3522,3522,0,11.215219
22/03/2018 09:29,201801,WESTERN EUROPE-EU,MALTA,EDINBURGH,MALTA,3185,3185,0,3114,3114,0,2.280026
22/03/2018 09:29,201801,WESTERN EUROPE-EU,MALTA,LEEDS BRADFORD,MALTA,2609,2609,0,2520,2520,0,3.531746
22/03/2018 09:29,201801,WESTERN EUROPE-EU,MALTA,LIVERPOOL (JOHN LENNON),MALTA,2866,2866,0,2804,2804,0,2.211127
22/03/2018 09:29,201801,WESTERN EUROPE-EU,MALTA,MANCHESTER,MALTA,12346,10678,1668,10298,8827,1471,19.887357
22/03/2018 09:29,201801,WESTERN EUROPE-EU,MALTA,NEWCASTLE,MALTA,1421,1421,0,1345,1345,0,5.650558
22/03/2018 09:29,201801,WESTERN EUROPE-EU,MALTA,PRESTWICK,MALTA,932,932,0,963,963,0,-3.219107
22/03/2018 09:29,201801,WESTERN EUROPE-EU,NETHERLANDS,GATWICK,AMSTERDAM,82774,82774,0,81424,81424,0,1.657988
22/03/2018 09:29,201801,WESTERN EUROPE-EU,NETHERLANDS,HEATHROW,AMSTERDAM,130265,130265,0,122783,122783,0,6.093677
22/03/2018 09:29,201801,WESTERN EUROPE-EU,NETHERLANDS,LONDON CITY,AMSTERDAM,43737,43737,0,36314,36314,0,20.441152
22/03/2018 09:29,201801,WESTERN EUROPE-EU,NETHERLANDS,LONDON CITY,ROTTERDAM,13253,13253,0,16116,16116,0,-17.764954
22/03/2018 09:29,201801,WESTERN EUROPE-EU,NETHERLANDS,LUTON,AMSTERDAM,62585,62585,0,52165,52060,105,19.975079
22/03/2018 09:29,201801,WESTERN EUROPE-EU,NETHERLANDS,SOUTHEND,AMSTERDAM,14150,14150,0,14783,14783,0,-4.281945
22/03/2018 09:29,201801,WESTERN EUROPE-EU,NETHERLANDS,SOUTHEND,GRONINGEN,1850,1850,0,1990,1990,0,-7.035176
22/03/2018 09:29,201801,WESTERN EUROPE-EU,NETHERLANDS,STANSTED,AMSTERDAM,27884,27884,0,27883,27883,0,0.003586
22/03/2018 09:29,201801,WESTERN EUROPE-EU,NETHERLANDS,STANSTED,EINDHOVEN,24475,24475,0,25862,25862,0,-5.363081
22/03/2018 09:29,201801,WESTERN EUROPE-EU,NETHERLANDS,STANSTED,ROTTERDAM,0,0,0,57,57,0,-100
22/03/2018 09:29,201801,WESTERN EUROPE-EU,NETHERLANDS,ABERDEEN,AMSTERDAM,19714,19714,0,18184,18184,0,8.41399
22/03/2018 09:29,201801,WESTERN EUROPE-EU,NETHERLANDS,BELFAST CITY (GEORGE BEST),AMSTERDAM,3082,3082,0,2756,2756,0,11.828737
22/03/2018 09:29,201801,WESTERN EUROPE-EU,NETHERLANDS,BELFAST INTERNATIONAL,AMSTERDAM,8646,8646,0,7376,7376,0,17.218004
22/03/2018 09:29,201801,WESTERN EUROPE-EU,NETHERLANDS,BIRMINGHAM,AMSTERDAM,53080,53080,0,46787,46787,0,13.450317
22/03/2018 09:29,201801,WESTERN EUROPE-EU,NETHERLANDS,BIRMINGHAM,ROTTERDAM,0,0,0,562,562,0,-100
22/03/2018 09:29,201801,WESTERN EUROPE-EU,NETHERLANDS,BOURNEMOUTH,AMSTERDAM,0,0,0,68,68,0,-100
22/03/2018 09:29,201801,WESTERN EUROPE-EU,NETHERLANDS,BRISTOL,AMSTERDAM,33100,33100,0,29846,29805,41,10.902634
22/03/2018 09:29,201801,WESTERN EUROPE-EU,NETHERLANDS,CARDIFF WALES,AMSTERDAM,10716,10716,0,8843,8843,0,21.180595
22/03/2018 09:29,201801,WESTERN EUROPE-EU,NETHERLANDS,DONCASTER SHEFFIELD,AMSTERDAM,4351,4351,0,4486,4486,0,-3.009362
22/03/2018 09:29,201801,WESTERN EUROPE-EU,NETHERLANDS,DURHAM TEES VALLEY,AMSTERDAM,7619,7549,70,7185,7185,0,6.040362
22/03/2018 09:29,201801,WESTERN EUROPE-EU,NETHERLANDS,EAST MIDLANDS INTERNATIONAL,AMSTERDAM,3411,3411,0,3034,3034,0,12.42584
22/03/2018 09:29,201801,WESTERN EUROPE-EU,NETHERLANDS,EDINBURGH,AMSTERDAM,43032,43032,0,43874,43874,0,-1.919132
22/03/2018 09:29,201801,WESTERN EUROPE-EU,NETHERLANDS,EDINBURGH,EINDHOVEN,3638,3638,0,0,0,0,0
22/03/2018 09:29,201801,WESTERN EUROPE-EU,NETHERLANDS,EXETER,AMSTERDAM,3356,3356,0,2699,2699,0,24.342349
22/03/2018 09:29,201801,WESTERN EUROPE-EU,NETHERLANDS,GLASGOW,AMSTERDAM,28360,28360,0,30021,30021,0,-5.532794
22/03/2018 09:29,201801,WESTERN EUROPE-EU,NETHERLANDS,HUMBERSIDE,AMSTERDAM,9310,9310,0,8449,8449,0,10.190555
22/03/2018 09:29,201801,WESTERN EUROPE-EU,NETHERLANDS,INVERNESS,AMSTERDAM,2938,2938,0,2812,2812,0,4.480797
22/03/2018 09:29,201801,WESTERN EUROPE-EU,NETHERLANDS,LEEDS BRADFORD,AMSTERDAM,18469,18385,84,17006,16942,64,8.602846
22/03/2018 09:29,201801,WESTERN EUROPE-EU,NETHERLANDS,LIVERPOOL (JOHN LENNON),AMSTERDAM,18765,18765,0,20907,20907,0,-10.245372
22/03/2018 09:29,201801,WESTERN EUROPE-EU,NETHERLANDS,MANCHESTER,AMSTERDAM,81402,81402,0,80813,80813,0,0.728843
22/03/2018 09:29,201801,WESTERN EUROPE-EU,NETHERLANDS,MANCHESTER,EINDHOVEN,6476,6476,0,6574,6574,0,-1.490721
22/03/2018 09:29,201801,WESTERN EUROPE-EU,NETHERLANDS,MANCHESTER,ROTTERDAM,0,0,0,193,193,0,-100
22/03/2018 09:29,201801,WESTERN EUROPE-EU,NETHERLANDS,NEWCASTLE,AMSTERDAM,26273,26212,61,27033,26992,41,-2.811379
22/03/2018 09:29,201801,WESTERN EUROPE-EU,NETHERLANDS,NORWICH,AMSTERDAM,9241,9241,0,8745,8745,0,5.671812
22/03/2018 09:29,201801,WESTERN EUROPE-EU,NETHERLANDS,SOUTHAMPTON,AMSTERDAM,16205,16205,0,14825,14825,0,9.3086
22/03/2018 09:29,201801,WESTERN EUROPE-EU,PORTUGAL(EXCLUDING MADEIRA),GATWICK,FARO,17786,17786,0,21921,21921,0,-18.863191
22/03/2018 09:29,201801,WESTERN EUROPE-EU,PORTUGAL(EXCLUDING MADEIRA),GATWICK,LISBON,24129,24129,0,24099,24099,0,0.124486
22/03/2018 09:29,201801,WESTERN EUROPE-EU,PORTUGAL(EXCLUDING MADEIRA),GATWICK,OPORTO (PORTUGAL),20925,20925,0,21894,21894,0,-4.42587
22/03/2018 09:29,201801,WESTERN EUROPE-EU,PORTUGAL(EXCLUDING MADEIRA),HEATHROW,LISBON,50258,50258,0,57705,57705,0,-12.905294
22/03/2018 09:29,201801,WESTERN EUROPE-EU,PORTUGAL(EXCLUDING MADEIRA),LONDON CITY,LISBON,5736,5736,0,0,0,0,0
22/03/2018 09:29,201801,WESTERN EUROPE-EU,PORTUGAL(EXCLUDING MADEIRA),LUTON,FARO,5067,5067,0,4638,4638,0,9.249677
22/03/2018 09:29,201801,WESTERN EUROPE-EU,PORTUGAL(EXCLUDING MADEIRA),LUTON,LISBON,15374,15374,0,8425,8425,0,82.480712
22/03/2018 09:29,201801,WESTERN EUROPE-EU,PORTUGAL(EXCLUDING MADEIRA),LUTON,OPORTO (PORTUGAL),3191,3191,0,2773,2773,0,15.073927
22/03/2018 09:29,201801,WESTERN EUROPE-EU,PORTUGAL(EXCLUDING MADEIRA),SOUTHEND,FARO,2690,2690,0,2537,2537,0,6.030745
22/03/2018 09:29,201801,WESTERN EUROPE-EU,PORTUGAL(EXCLUDING MADEIRA),STANSTED,AZORES PONTA DELGADA,1135,1135,0,0,0,0,0
22/03/2018 09:29,201801,WESTERN EUROPE-EU,PORTUGAL(EXCLUDING MADEIRA),STANSTED,FARO,10736,10736,0,10293,10293,0,4.303896
22/03/2018 09:29,201801,WESTERN EUROPE-EU,PORTUGAL(EXCLUDING MADEIRA),STANSTED,LISBON,25191,25191,0,31123,31123,0,-19.059859
22/03/2018 09:29,201801,WESTERN EUROPE-EU,PORTUGAL(EXCLUDING MADEIRA),STANSTED,OPORTO (PORTUGAL),24287,24287,0,24474,24474,0,-0.764076
22/03/2018 09:29,201801,WESTERN EUROPE-EU,PORTUGAL(EXCLUDING MADEIRA),BELFAST INTERNATIONAL,FARO,3697,3697,0,2629,2629,0,40.623811
22/03/2018 09:29,201801,WESTERN EUROPE-EU,PORTUGAL(EXCLUDING MADEIRA),BIRMINGHAM,FARO,3726,3726,0,8800,7371,1429,-57.659091
22/03/2018 09:29,201801,WESTERN EUROPE-EU,PORTUGAL(EXCLUDING MADEIRA),BIRMINGHAM,LISBON,0,0,0,3361,3361,0,-100
22/03/2018 09:29,201801,WESTERN EUROPE-EU,PORTUGAL(EXCLUDING MADEIRA),BOURNEMOUTH,FARO,2853,2853,0,2185,2185,0,30.572082
22/03/2018 09:29,201801,WESTERN EUROPE-EU,PORTUGAL(EXCLUDING MADEIRA),BRISTOL,FARO,10057,10057,0,9834,9834,0,2.267643
22/03/2018 09:29,201801,WESTERN EUROPE-EU,PORTUGAL(EXCLUDING MADEIRA),BRISTOL,LISBON,3416,3416,0,3306,3306,0,3.327284
22/03/2018 09:29,201801,WESTERN EUROPE-EU,PORTUGAL(EXCLUDING MADEIRA),BRISTOL,OPORTO (PORTUGAL),3116,3116,0,3050,3050,0,2.163934
22/03/2018 09:29,201801,WESTERN EUROPE-EU,PORTUGAL(EXCLUDING MADEIRA),CARDIFF WALES,FARO,288,288,0,858,858,0,-66.433566
22/03/2018 09:29,201801,WESTERN EUROPE-EU,PORTUGAL(EXCLUDING MADEIRA),EAST MIDLANDS INTERNATIONAL,FARO,3629,3629,0,2917,2917,0,24.408639
22/03/2018 09:29,201801,WESTERN EUROPE-EU,PORTUGAL(EXCLUDING MADEIRA),EDINBURGH,FARO,2948,2948,0,3118,3118,0,-5.452213
22/03/2018 09:29,201801,WESTERN EUROPE-EU,PORTUGAL(EXCLUDING MADEIRA),EDINBURGH,LISBON,2599,2599,0,3440,3440,0,-24.447674
22/03/2018 09:29,201801,WESTERN EUROPE-EU,PORTUGAL(EXCLUDING MADEIRA),EDINBURGH,OPORTO (PORTUGAL),2659,2659,0,0,0,0,0
22/03/2018 09:29,201801,WESTERN EUROPE-EU,PORTUGAL(EXCLUDING MADEIRA),EXETER,FARO,144,144,0,0,0,0,0
22/03/2018 09:29,201801,WESTERN EUROPE-EU,PORTUGAL(EXCLUDING MADEIRA),GLASGOW,FARO,3004,3004,0,2482,2482,0,21.031426
22/03/2018 09:29,201801,WESTERN EUROPE-EU,PORTUGAL(EXCLUDING MADEIRA),GLASGOW,LISBON,2786,2786,0,0,0,0,0
22/03/2018 09:29,201801,WESTERN EUROPE-EU,PORTUGAL(EXCLUDING MADEIRA),JERSEY,FARO,131,131,0,0,0,0,0
22/03/2018 09:29,201801,WESTERN EUROPE-EU,PORTUGAL(EXCLUDING MADEIRA),LEEDS BRADFORD,FARO,3798,3798,0,5645,5645,0,-32.719221
22/03/2018 09:29,201801,WESTERN EUROPE-EU,PORTUGAL(EXCLUDING MADEIRA),LIVERPOOL (JOHN LENNON),FARO,6065,6065,0,5394,5394,0,12.439748
22/03/2018 09:29,201801,WESTERN EUROPE-EU,PORTUGAL(EXCLUDING MADEIRA),LIVERPOOL (JOHN LENNON),LISBON,2371,2371,0,2283,2283,0,3.854577
22/03/2018 09:29,201801,WESTERN EUROPE-EU,PORTUGAL(EXCLUDING MADEIRA),LIVERPOOL (JOHN LENNON),OPORTO (PORTUGAL),2732,2732,0,2575,2575,0,6.097087
22/03/2018 09:29,201801,WESTERN EUROPE-EU,PORTUGAL(EXCLUDING MADEIRA),MANCHESTER,FARO,8215,8215,0,13228,13228,0,-37.896885
22/03/2018 09:29,201801,WESTERN EUROPE-EU,PORTUGAL(EXCLUDING MADEIRA),MANCHESTER,LISBON,13741,13741,0,15495,15495,0,-11.319781
22/03/2018 09:29,201801,WESTERN EUROPE-EU,PORTUGAL(EXCLUDING MADEIRA),MANCHESTER,OPORTO (PORTUGAL),2884,2884,0,2412,2412,0,19.568823
22/03/2018 09:29,201801,WESTERN EUROPE-EU,PORTUGAL(EXCLUDING MADEIRA),NEWCASTLE,FARO,2547,2547,0,2488,2488,0,2.371383
22/03/2018 09:29,201801,WESTERN EUROPE-EU,PORTUGAL(EXCLUDING MADEIRA),PRESTWICK,FARO,1307,1307,0,2113,2113,0,-38.144818
22/03/2018 09:29,201801,WESTERN EUROPE-EU,PORTUGAL(EXCLUDING MADEIRA),SOUTHAMPTON,FARO,0,0,0,751,751,0,-100
22/03/2018 09:29,201801,WESTERN EUROPE-EU,PORTUGAL(MADEIRA),GATWICK,FUNCHAL,19127,17005,2122,24315,20911,3404,-21.336623
22/03/2018 09:29,201801,WESTERN EUROPE-EU,PORTUGAL(MADEIRA),STANSTED,FUNCHAL,2725,2725,0,0,0,0,0
22/03/2018 09:29,201801,WESTERN EUROPE-EU,PORTUGAL(MADEIRA),BIRMINGHAM,FUNCHAL,2015,1502,513,3607,2061,1546,-44.136401
22/03/2018 09:29,201801,WESTERN EUROPE-EU,PORTUGAL(MADEIRA),BRISTOL,FUNCHAL,3515,3515,0,3464,3464,0,1.472286
22/03/2018 09:29,201801,WESTERN EUROPE-EU,PORTUGAL(MADEIRA),CARDIFF WALES,FUNCHAL,183,183,0,0,0,0,0
22/03/2018 09:29,201801,WESTERN EUROPE-EU,PORTUGAL(MADEIRA),EAST MIDLANDS INTERNATIONAL,FUNCHAL,3194,1414,1780,2958,1340,1618,7.978364
22/03/2018 09:29,201801,WESTERN EUROPE-EU,PORTUGAL(MADEIRA),EDINBURGH,FUNCHAL,1556,1556,0,2488,2488,0,-37.459807
22/03/2018 09:29,201801,WESTERN EUROPE-EU,PORTUGAL(MADEIRA),GLASGOW,FUNCHAL,1422,1422,0,3039,1301,1738,-53.208292
22/03/2018 09:29,201801,WESTERN EUROPE-EU,PORTUGAL(MADEIRA),JERSEY,FUNCHAL,1999,1999,0,2041,2041,0,-2.057815
22/03/2018 09:29,201801,WESTERN EUROPE-EU,PORTUGAL(MADEIRA),LEEDS BRADFORD,FUNCHAL,1721,1721,0,1410,1410,0,22.056738
22/03/2018 09:29,201801,WESTERN EUROPE-EU,PORTUGAL(MADEIRA),MANCHESTER,FUNCHAL,7901,5797,2104,9375,6174,3201,-15.722667
22/03/2018 09:29,201801,WESTERN EUROPE-EU,PORTUGAL(MADEIRA),NEWCASTLE,FUNCHAL,1235,1235,0,1084,1084,0,13.929889
22/03/2018 09:29,201801,WESTERN EUROPE-EU,SLOVENIA,GATWICK,LJUBLJANA,5102,5102,0,4470,4470,0,14.138702
22/03/2018 09:29,201801,WESTERN EUROPE-EU,SLOVENIA,LUTON,LJUBLJANA,4734,4734,0,4917,4917,0,-3.721782
22/03/2018 09:29,201801,WESTERN EUROPE-EU,SLOVENIA,STANSTED,LJUBLJANA,5733,5733,0,5571,5571,0,2.907916
22/03/2018 09:29,201801,WESTERN EUROPE-EU,SPAIN,GATWICK,ALICANTE,31249,29413,1836,38191,36375,1816,-18.177057
22/03/2018 09:29,201801,WESTERN EUROPE-EU,SPAIN,GATWICK,ALMERIA,4358,4358,0,6664,6664,0,-34.603842
22/03/2018 09:29,201801,WESTERN EUROPE-EU,SPAIN,GATWICK,ASTURIAS,3022,3022,0,3077,3077,0,-1.787455
22/03/2018 09:29,201801,WESTERN EUROPE-EU,SPAIN,GATWICK,BARCELONA,80827,80827,0,84053,83706,347,-3.838055
22/03/2018 09:29,201801,WESTERN EUROPE-EU,SPAIN,GATWICK,BILBAO,8181,8181,0,8645,8645,0,-5.367264
22/03/2018 09:29,201801,WESTERN EUROPE-EU,SPAIN,GATWICK,GRANADA,2558,2558,0,0,0,0,0
22/03/2018 09:29,201801,WESTERN EUROPE-EU,SPAIN,GATWICK,LIEIDA,1982,1982,0,2945,0,2945,-32.699491
22/03/2018 09:29,201801,WESTERN EUROPE-EU,SPAIN,GATWICK,MADRID,78636,78615,21,71222,71222,0,10.409705
22/03/2018 09:29,201801,WESTERN EUROPE-EU,SPAIN,GATWICK,MAHON,0,0,0,1351,1351,0,-100
22/03/2018 09:29,201801,WESTERN EUROPE-EU,SPAIN,GATWICK,MALAGA,47171,45827,1344,48149,45307,2842,-2.031195
22/03/2018 09:29,201801,WESTERN EUROPE-EU,SPAIN,GATWICK,MURCIA SAN JAVIER,6322,6322,0,6659,6659,0,-5.06082
22/03/2018 09:29,201801,WESTERN EUROPE-EU,SPAIN,GATWICK,PALMA DE MALLORCA,13944,13944,0,13871,13871,0,0.526278
22/03/2018 09:29,201801,WESTERN EUROPE-EU,SPAIN,GATWICK,REUS,0,0,0,535,0,535,-100
22/03/2018 09:29,201801,WESTERN EUROPE-EU,SPAIN,GATWICK,SANTIAGO DE COMPOSTELA (SPAIN),1113,1113,0,2673,2673,0,-58.361392
22/03/2018 09:29,201801,WESTERN EUROPE-EU,SPAIN,GATWICK,SEVILLE,11426,11426,0,11607,11607,0,-1.559404
22/03/2018 09:29,201801,WESTERN EUROPE-EU,SPAIN,GATWICK,VALENCIA,19005,19005,0,16710,16710,0,13.734291
22/03/2018 09:29,201801,WESTERN EUROPE-EU,SPAIN,GATWICK,ZARAGOZA,94,0,94,0,0,0,0
22/03/2018 09:29,201801,WESTERN EUROPE-EU,SPAIN,HEATHROW,A CORUNA,8535,8535,0,7504,7504,0,13.739339
22/03/2018 09:29,201801,WESTERN EUROPE-EU,SPAIN,HEATHROW,ASTURIAS,1374,1374,0,2426,2426,0,-43.363561
22/03/2018 09:29,201801,WESTERN EUROPE-EU,SPAIN,HEATHROW,BARCELONA,50178,50178,0,38956,38956,0,28.806859
22/03/2018 09:29,201801,WESTERN EUROPE-EU,SPAIN,HEATHROW,BILBAO,8554,8554,0,8544,8544,0,0.117041
22/03/2018 09:29,201801,WESTERN EUROPE-EU,SPAIN,HEATHROW,MADRID,100933,100933,0,96396,96396,0,4.706627
22/03/2018 09:29,201801,WESTERN EUROPE-EU,SPAIN,HEATHROW,MALAGA,2456,2456,0,0,0,0,0
22/03/2018 09:29,201801,WESTERN EUROPE-EU,SPAIN,HEATHROW,PALMA DE MALLORCA,2518,2518,0,0,0,0,0
22/03/2018 09:29,201801,WESTERN EUROPE-EU,SPAIN,LONDON CITY,GRANADA,0,0,0,1020,1020,0,-100
22/03/2018 09:29,201801,WESTERN EUROPE-EU,SPAIN,LONDON CITY,IBIZA,3960,3960,0,3526,3526,0,12.308565
22/03/2018 09:29,201801,WESTERN EUROPE-EU,SPAIN,LONDON CITY,MADRID,0,0,0,4675,4675,0,-100
22/03/2018 09:29,201801,WESTERN EUROPE-EU,SPAIN,LONDON CITY,MALAGA,4206,4206,0,3922,3922,0,7.241203
22/03/2018 09:29,201801,WESTERN EUROPE-EU,SPAIN,LONDON CITY,PALMA DE MALLORCA,1473,1473,0,1408,1408,0,4.616477
22/03/2018 09:29,201801,WESTERN EUROPE-EU,SPAIN,LUTON,ALICANTE,8344,8344,0,9946,9946,0,-16.106978
22/03/2018 09:29,201801,WESTERN EUROPE-EU,SPAIN,LUTON,BARCELONA,32753,32753,0,31165,31165,0,5.09546
22/03/2018 09:29,201801,WESTERN EUROPE-EU,SPAIN,LUTON,IBIZA,0,0,0,1,0,1,-100
22/03/2018 09:29,201801,WESTERN EUROPE-EU,SPAIN,LUTON,MADRID,5777,5777,0,7331,7331,0,-21.197654
22/03/2018 09:29,201801,WESTERN EUROPE-EU,SPAIN,LUTON,MALAGA,7075,7075,0,10114,10114,0,-30.047459
22/03/2018 09:29,201801,WESTERN EUROPE-EU,SPAIN,LUTON,MURCIA SAN JAVIER,4311,4311,0,4307,4307,0,0.092872
22/03/2018 09:29,201801,WESTERN EUROPE-EU,SPAIN,LUTON,PALMA DE MALLORCA,2467,2467,0,2690,2690,0,-8.289963
22/03/2018 09:29,201801,WESTERN EUROPE-EU,SPAIN,LUTON,SEVILLE,3516,3516,0,0,0,0,0
22/03/2018 09:29,201801,WESTERN EUROPE-EU,SPAIN,LUTON,VALENCIA,3478,3478,0,0,0,0,0
22/03/2018 09:29,201801,WESTERN EUROPE-EU,SPAIN,SOUTHEND,ALICANTE,4380,4380,0,5874,5874,0,-25.434116
22/03/2018 09:29,201801,WESTERN EUROPE-EU,SPAIN,SOUTHEND,BARCELONA,2015,2015,0,1766,1766,0,14.09966
22/03/2018 09:29,201801,WESTERN EUROPE-EU,SPAIN,SOUTHEND,MALAGA,3201,3201,0,3306,3306,0,-3.176044
22/03/2018 09:29,201801,WESTERN EUROPE-EU,SPAIN,STANSTED,ALICANTE,20401,20401,0,14816,14816,0,37.695734
22/03/2018 09:29,201801,WESTERN EUROPE-EU,SPAIN,STANSTED,ASTURIAS,3552,3552,0,3985,3985,0,-10.865747
22/03/2018 09:29,201801,WESTERN EUROPE-EU,SPAIN,STANSTED,BARCELONA,32629,32629,0,43647,43478,169,-25.24343
22/03/2018 09:29,201801,WESTERN EUROPE-EU,SPAIN,STANSTED,BILBAO,4946,4946,0,5319,5319,0,-7.012596
22/03/2018 09:29,201801,WESTERN EUROPE-EU,SPAIN,STANSTED,CASTELLON COSTA AZAHAR,2209,2209,0,2411,2411,0,-8.378266
22/03/2018 09:29,201801,WESTERN EUROPE-EU,SPAIN,STANSTED,CASTELLON DE LA PLANA AIRPORT,1252,1252,0,1252,1252,0,0
22/03/2018 09:29,201801,WESTERN EUROPE-EU,SPAIN,STANSTED,GIRONA,0,0,0,167,0,167,-100
22/03/2018 09:29,201801,WESTERN EUROPE-EU,SPAIN,STANSTED,IBIZA,0,0,0,57,57,0,-100
22/03/2018 09:29,201801,WESTERN EUROPE-EU,SPAIN,STANSTED,JEREZ,2748,2748,0,2747,2747,0,0.036403
22/03/2018 09:29,201801,WESTERN EUROPE-EU,SPAIN,STANSTED,LIEIDA,1485,0,1485,0,0,0,0
22/03/2018 09:29,201801,WESTERN EUROPE-EU,SPAIN,STANSTED,MADRID,31123,31123,0,40568,40568,0,-23.281897
22/03/2018 09:29,201801,WESTERN EUROPE-EU,SPAIN,STANSTED,MALAGA,29912,29912,0,23689,23689,0,26.269577
22/03/2018 09:29,201801,WESTERN EUROPE-EU,SPAIN,STANSTED,MURCIA SAN JAVIER,6423,6423,0,6250,6250,0,2.768
22/03/2018 09:29,201801,WESTERN EUROPE-EU,SPAIN,STANSTED,PALMA DE MALLORCA,10813,10813,0,10670,10670,0,1.340206
22/03/2018 09:29,201801,WESTERN EUROPE-EU,SPAIN,STANSTED,REUS,2554,2554,0,2562,2562,0,-0.312256
22/03/2018 09:29,201801,WESTERN EUROPE-EU,SPAIN,STANSTED,SANTANDER,6292,6292,0,6349,6349,0,-0.897779
22/03/2018 09:29,201801,WESTERN EUROPE-EU,SPAIN,STANSTED,SANTIAGO DE COMPOSTELA (SPAIN),5048,5048,0,4952,4952,0,1.938611
22/03/2018 09:29,201801,WESTERN EUROPE-EU,SPAIN,STANSTED,SEVILLE,13321,13321,0,13361,13361,0,-0.299379
22/03/2018 09:29,201801,WESTERN EUROPE-EU,SPAIN,STANSTED,VALENCIA,10703,10703,0,10437,10437,0,2.548625
22/03/2018 09:29,201801,WESTERN EUROPE-EU,SPAIN,STANSTED,ZARAGOZA,7084,7084,0,7370,7370,0,-3.880597
22/03/2018 09:29,201801,WESTERN EUROPE-EU,SPAIN,ABERDEEN,ALICANTE,2186,2186,0,0,0,0,0
22/03/2018 09:29,201801,WESTERN EUROPE-EU,SPAIN,ABERDEEN,MALAGA,2378,2378,0,0,0,0,0
22/03/2018 09:29,201801,WESTERN EUROPE-EU,SPAIN,BELFAST INTERNATIONAL,ALICANTE,8525,8525,0,7879,7879,0,8.19901
22/03/2018 09:29,201801,WESTERN EUROPE-EU,SPAIN,BELFAST INTERNATIONAL,MALAGA,9559,9559,0,9025,9025,0,5.916898
22/03/2018 09:29,201801,WESTERN EUROPE-EU,SPAIN,BIRMINGHAM,ALICANTE,17157,15302,1855,18980,17010,1970,-9.604847
22/03/2018 09:29,201801,WESTERN EUROPE-EU,SPAIN,BIRMINGHAM,BARCELONA,11157,11157,0,15152,14865,287,-26.366156
22/03/2018 09:29,201801,WESTERN EUROPE-EU,SPAIN,BIRMINGHAM,BILBAO,0,0,0,370,0,370,-100
22/03/2018 09:29,201801,WESTERN EUROPE-EU,SPAIN,BIRMINGHAM,GIRONA,0,0,0,312,0,312,-100
22/03/2018 09:29,201801,WESTERN EUROPE-EU,SPAIN,BIRMINGHAM,LIEIDA,0,0,0,593,0,593,-100
22/03/2018 09:29,201801,WESTERN EUROPE-EU,SPAIN,BIRMINGHAM,MADRID,8706,8706,0,8369,8369,0,4.026765
22/03/2018 09:29,201801,WESTERN EUROPE-EU,SPAIN,BIRMINGHAM,MALAGA,13377,12063,1314,18367,16473,1894,-27.168291
22/03/2018 09:29,201801,WESTERN EUROPE-EU,SPAIN,BIRMINGHAM,MURCIA SAN JAVIER,3055,3055,0,2618,2618,0,16.692131
22/03/2018 09:29,201801,WESTERN EUROPE-EU,SPAIN,BIRMINGHAM,PALMA DE MALLORCA,0,0,0,2425,2425,0,-100
22/03/2018 09:29,201801,WESTERN EUROPE-EU,SPAIN,BOURNEMOUTH,ALICANTE,3388,3388,0,3428,3428,0,-1.166861
22/03/2018 09:29,201801,WESTERN EUROPE-EU,SPAIN,BOURNEMOUTH,MALAGA,3150,3150,0,3368,3368,0,-6.472684
22/03/2018 09:29,201801,WESTERN EUROPE-EU,SPAIN,BRISTOL,ALICANTE,14809,14809,0,14906,14906,0,-0.650745
22/03/2018 09:29,201801,WESTERN EUROPE-EU,SPAIN,BRISTOL,BARCELONA,10744,10744,0,10815,10815,0,-0.656496
22/03/2018 09:29,201801,WESTERN EUROPE-EU,SPAIN,BRISTOL,BILBAO,1823,1823,0,1804,1804,0,1.053215
22/03/2018 09:29,201801,WESTERN EUROPE-EU,SPAIN,BRISTOL,MADRID,6506,6506,0,6594,6594,0,-1.334547
22/03/2018 09:29,201801,WESTERN EUROPE-EU,SPAIN,BRISTOL,MALAGA,15852,14466,1386,16269,14540,1729,-2.563157
22/03/2018 09:29,201801,WESTERN EUROPE-EU,SPAIN,BRISTOL,MURCIA SAN JAVIER,3051,3051,0,2889,2889,0,5.607477
22/03/2018 09:29,201801,WESTERN EUROPE-EU,SPAIN,BRISTOL,PALMA DE MALLORCA,3279,3279,0,3299,3299,0,-0.606244
22/03/2018 09:29,201801,WESTERN EUROPE-EU,SPAIN,CARDIFF WALES,ALICANTE,6483,3196,3287,6406,3213,3193,1.201998
22/03/2018 09:29,201801,WESTERN EUROPE-EU,SPAIN,CARDIFF WALES,MADRID,310,310,0,0,0,0,0
22/03/2018 09:29,201801,WESTERN EUROPE-EU,SPAIN,CARDIFF WALES,MALAGA,3604,2273,1331,3673,2358,1315,-1.878573
22/03/2018 09:29,201801,WESTERN EUROPE-EU,SPAIN,DONCASTER SHEFFIELD,ALICANTE,4384,417,3967,5314,577,4737,-17.500941
22/03/2018 09:29,201801,WESTERN EUROPE-EU,SPAIN,DONCASTER SHEFFIELD,MALAGA,1497,0,1497,2471,452,2019,-39.41724
22/03/2018 09:29,201801,WESTERN EUROPE-EU,SPAIN,EAST MIDLANDS INTERNATIONAL,ALICANTE,17651,15812,1839,18152,16378,1774,-2.760026
22/03/2018 09:29,201801,WESTERN EUROPE-EU,SPAIN,EAST MIDLANDS INTERNATIONAL,ASTURIAS,0,0,0,90,0,90,-100
22/03/2018 09:29,201801,WESTERN EUROPE-EU,SPAIN,EAST MIDLANDS INTERNATIONAL,BARCELONA,0,0,0,5131,5131,0,-100
22/03/2018 09:29,201801,WESTERN EUROPE-EU,SPAIN,EAST MIDLANDS INTERNATIONAL,LIEIDA,710,133,577,0,0,0,0
22/03/2018 09:29,201801,WESTERN EUROPE-EU,SPAIN,EAST MIDLANDS INTERNATIONAL,MALAGA,11019,9751,1268,11508,10019,1489,-4.249218
22/03/2018 09:29,201801,WESTERN EUROPE-EU,SPAIN,EAST MIDLANDS INTERNATIONAL,MURCIA SAN JAVIER,4112,4112,0,3515,3515,0,16.984353
22/03/2018 09:29,201801,WESTERN EUROPE-EU,SPAIN,EAST MIDLANDS INTERNATIONAL,SEVILLE,2212,2212,0,0,0,0,0
22/03/2018 09:29,201801,WESTERN EUROPE-EU,SPAIN,EDINBURGH,ALICANTE,11281,11281,0,14246,14246,0,-20.81286
22/03/2018 09:29,201801,WESTERN EUROPE-EU,SPAIN,EDINBURGH,BARCELONA,9156,9156,0,10297,10297,0,-11.080897
22/03/2018 09:29,201801,WESTERN EUROPE-EU,SPAIN,EDINBURGH,BILBAO,1987,1987,0,0,0,0,0
22/03/2018 09:29,201801,WESTERN EUROPE-EU,SPAIN,EDINBURGH,MADRID,7323,7323,0,8022,8022,0,-8.713538
22/03/2018 09:29,201801,WESTERN EUROPE-EU,SPAIN,EDINBURGH,MALAGA,6963,6963,0,8579,8579,0,-18.836694
22/03/2018 09:29,201801,WESTERN EUROPE-EU,SPAIN,EDINBURGH,PALMA DE MALLORCA,0,0,0,2650,2650,0,-100
22/03/2018 09:29,201801,WESTERN EUROPE-EU,SPAIN,EDINBURGH,SANTANDER,2612,2612,0,2645,2645,0,-1.247637
22/03/2018 09:29,201801,WESTERN EUROPE-EU,SPAIN,EDINBURGH,VALENCIA,3760,3760,0,0,0,0,0
22/03/2018 09:29,201801,WESTERN EUROPE-EU,SPAIN,EXETER,ALICANTE,2179,2179,0,1424,1424,0,53.019663
22/03/2018 09:29,201801,WESTERN EUROPE-EU,SPAIN,EXETER,MALAGA,1489,1489,0,1361,1361,0,9.404849
22/03/2018 09:29,201801,WESTERN EUROPE-EU,SPAIN,GLASGOW,ALICANTE,16516,14388,2128,13590,11526,2064,21.530537
22/03/2018 09:29,201801,WESTERN EUROPE-EU,SPAIN,GLASGOW,BARCELONA,572,572,0,2419,2419,0,-76.353865
22/03/2018 09:29,201801,WESTERN EUROPE-EU,SPAIN,GLASGOW,MADRID,5173,5173,0,0,0,0,0
22/03/2018 09:29,201801,WESTERN EUROPE-EU,SPAIN,GLASGOW,MALAGA,10738,10738,0,10371,10371,0,3.538714
22/03/2018 09:29,201801,WESTERN EUROPE-EU,SPAIN,GLASGOW,VALENCIA,2301,2301,0,0,0,0,0
22/03/2018 09:29,201801,WESTERN EUROPE-EU,SPAIN,LEEDS BRADFORD,ALICANTE,13643,13643,0,14882,14882,0,-8.325494
22/03/2018 09:29,201801,WESTERN EUROPE-EU,SPAIN,LEEDS BRADFORD,BARCELONA,532,532,0,255,255,0,108.627451
22/03/2018 09:29,201801,WESTERN EUROPE-EU,SPAIN,LEEDS BRADFORD,MALAGA,11416,11416,0,11507,11507,0,-0.790823
22/03/2018 09:29,201801,WESTERN EUROPE-EU,SPAIN,LEEDS BRADFORD,MURCIA SAN JAVIER,2806,2806,0,0,0,0,0
22/03/2018 09:29,201801,WESTERN EUROPE-EU,SPAIN,LIVERPOOL (JOHN LENNON),ALICANTE,15417,15417,0,11759,11759,0,31.108087
22/03/2018 09:29,201801,WESTERN EUROPE-EU,SPAIN,LIVERPOOL (JOHN LENNON),BARCELONA,11882,11882,0,12844,12844,0,-7.489879
22/03/2018 09:29,201801,WESTERN EUROPE-EU,SPAIN,LIVERPOOL (JOHN LENNON),MADRID,5303,5303,0,5288,5288,0,0.283661
22/03/2018 09:29,201801,WESTERN EUROPE-EU,SPAIN,LIVERPOOL (JOHN LENNON),MALAGA,11500,11500,0,10516,10516,0,9.35717
22/03/2018 09:29,201801,WESTERN EUROPE-EU,SPAIN,LIVERPOOL (JOHN LENNON),PALMA DE MALLORCA,2534,2534,0,2467,2467,0,2.715849
22/03/2018 09:29,201801,WESTERN EUROPE-EU,SPAIN,MANCHESTER,ALICANTE,34758,29091,5667,40191,33746,6445,-13.517952
22/03/2018 09:29,201801,WESTERN EUROPE-EU,SPAIN,MANCHESTER,ALMERIA,0,0,0,2396,2396,0,-100
22/03/2018 09:29,201801,WESTERN EUROPE-EU,SPAIN,MANCHESTER,BARCELONA,17524,17524,0,21792,21472,320,-19.585169
22/03/2018 09:29,201801,WESTERN EUROPE-EU,SPAIN,MANCHESTER,BILBAO,2980,2980,0,3155,3155,0,-5.546751
22/03/2018 09:29,201801,WESTERN EUROPE-EU,SPAIN,MANCHESTER,GIRONA,0,0,0,278,0,278,-100
22/03/2018 09:29,201801,WESTERN EUROPE-EU,SPAIN,MANCHESTER,GRANADA,2696,2696,0,0,0,0,0
22/03/2018 09:29,201801,WESTERN EUROPE-EU,SPAIN,MANCHESTER,LIEIDA,2083,2083,0,2073,0,2073,0.482393
22/03/2018 09:29,201801,WESTERN EUROPE-EU,SPAIN,MANCHESTER,MADRID,11126,11126,0,13383,13383,0,-16.864679
22/03/2018 09:29,201801,WESTERN EUROPE-EU,SPAIN,MANCHESTER,MALAGA,22408,19577,2831,29794,26665,3129,-24.790226
22/03/2018 09:29,201801,WESTERN EUROPE-EU,SPAIN,MANCHESTER,MURCIA SAN JAVIER,4861,4861,0,4231,4231,0,14.890097
22/03/2018 09:29,201801,WESTERN EUROPE-EU,SPAIN,MANCHESTER,PALMA DE MALLORCA,5510,5510,0,5975,5975,0,-7.782427
22/03/2018 09:29,201801,WESTERN EUROPE-EU,SPAIN,MANCHESTER,SEVILLE,3122,3122,0,0,0,0,0
22/03/2018 09:29,201801,WESTERN EUROPE-EU,SPAIN,MANCHESTER,VALENCIA,3066,3066,0,2892,2892,0,6.016598
22/03/2018 09:29,201801,WESTERN EUROPE-EU,SPAIN,NEWCASTLE,ALICANTE,18322,18152,170,17873,17873,0,2.512169
22/03/2018 09:29,201801,WESTERN EUROPE-EU,SPAIN,NEWCASTLE,BARCELONA,3212,3212,0,4163,4163,0,-22.844103
22/03/2018 09:29,201801,WESTERN EUROPE-EU,SPAIN,NEWCASTLE,MADRID,2649,2649,0,0,0,0,0
22/03/2018 09:29,201801,WESTERN EUROPE-EU,SPAIN,NEWCASTLE,MALAGA,12848,12848,0,13184,13184,0,-2.548544
22/03/2018 09:29,201801,WESTERN EUROPE-EU,SPAIN,NORWICH,ALICANTE,215,215,0,958,958,0,-77.557411
22/03/2018 09:29,201801,WESTERN EUROPE-EU,SPAIN,NORWICH,MALAGA,115,115,0,835,835,0,-86.227545
22/03/2018 09:29,201801,WESTERN EUROPE-EU,SPAIN,PRESTWICK,ALICANTE,3988,3988,0,4057,4057,0,-1.700764
22/03/2018 09:29,201801,WESTERN EUROPE-EU,SPAIN,PRESTWICK,BARCELONA,2582,2582,0,3388,3388,0,-23.789847
22/03/2018 09:29,201801,WESTERN EUROPE-EU,SPAIN,PRESTWICK,MALAGA,2441,2441,0,2540,2540,0,-3.897638
22/03/2018 09:29,201801,WESTERN EUROPE-EU,SPAIN,SOUTHAMPTON,ALICANTE,1239,1239,0,1413,1413,0,-12.314225
22/03/2018 09:29,201801,WESTERN EUROPE-EU,SPAIN,SOUTHAMPTON,MALAGA,0,0,0,1486,1486,0,-100
22/03/2018 09:29,201801,WESTERN EUROPE-EU,SPAIN(CANARY ISLANDS),GATWICK,ARRECIFE,26460,20129,6331,30056,23194,6862,-11.964333
22/03/2018 09:29,201801,WESTERN EUROPE-EU,SPAIN(CANARY ISLANDS),GATWICK,FUERTEVENTURA,18201,14651,3550,18404,14713,3691,-1.103021
22/03/2018 09:29,201801,WESTERN EUROPE-EU,SPAIN(CANARY ISLANDS),GATWICK,LAS PALMAS,19550,14214,5336,22204,15964,6240,-11.952801
22/03/2018 09:29,201801,WESTERN EUROPE-EU,SPAIN(CANARY ISLANDS),GATWICK,SANTA CRUZ DE LA PALMA,4049,2656,1393,5133,2326,2807,-21.118254
22/03/2018 09:29,201801,WESTERN EUROPE-EU,SPAIN(CANARY ISLANDS),GATWICK,TENERIFE (SURREINA SOFIA),49571,38959,10612,56339,45002,11337,-12.012993
22/03/2018 09:29,201801,WESTERN EUROPE-EU,SPAIN(CANARY ISLANDS),HEATHROW,LAS PALMAS,1083,1083,0,4098,4098,0,-73.572474
22/03/2018 09:29,201801,WESTERN EUROPE-EU,SPAIN(CANARY ISLANDS),HEATHROW,TENERIFE (NORTE LOS RODEOS),0,0,0,211,211,0,-100
22/03/2018 09:29,201801,WESTERN EUROPE-EU,SPAIN(CANARY ISLANDS),HEATHROW,TENERIFE (SURREINA SOFIA),1012,1012,0,0,0,0,0
22/03/2018 09:29,201801,WESTERN EUROPE-EU,SPAIN(CANARY ISLANDS),LUTON,ARRECIFE,8110,6602,1508,9561,7805,1756,-15.176237
22/03/2018 09:29,201801,WESTERN EUROPE-EU,SPAIN(CANARY ISLANDS),LUTON,FUERTEVENTURA,2924,2731,193,4299,2753,1546,-31.984182
22/03/2018 09:29,201801,WESTERN EUROPE-EU,SPAIN(CANARY ISLANDS),LUTON,LAS PALMAS,1293,0,1293,3836,2692,1144,-66.293014
22/03/2018 09:29,201801,WESTERN EUROPE-EU,SPAIN(CANARY ISLANDS),LUTON,TENERIFE (SURREINA SOFIA),10577,7447,3130,14040,11241,2799,-24.665242
22/03/2018 09:29,201801,WESTERN EUROPE-EU,SPAIN(CANARY ISLANDS),SOUTHEND,ARRECIFE,2922,2922,0,2470,2470,0,18.299595
22/03/2018 09:29,201801,WESTERN EUROPE-EU,SPAIN(CANARY ISLANDS),SOUTHEND,LAS PALMAS,0,0,0,2200,2200,0,-100
22/03/2018 09:29,201801,WESTERN EUROPE-EU,SPAIN(CANARY ISLANDS),SOUTHEND,TENERIFE (SURREINA SOFIA),3011,3011,0,2856,2856,0,5.427171
22/03/2018 09:29,201801,WESTERN EUROPE-EU,SPAIN(CANARY ISLANDS),STANSTED,ARRECIFE,16111,14694,1417,10471,9079,1392,53.86305
22/03/2018 09:29,201801,WESTERN EUROPE-EU,SPAIN(CANARY ISLANDS),STANSTED,FUERTEVENTURA,12256,10441,1815,9442,7960,1482,29.803008
22/03/2018 09:29,201801,WESTERN EUROPE-EU,SPAIN(CANARY ISLANDS),STANSTED,LAS PALMAS,14286,12641,1645,10148,8585,1563,40.776508
22/03/2018 09:29,201801,WESTERN EUROPE-EU,SPAIN(CANARY ISLANDS),STANSTED,TENERIFE (SURREINA SOFIA),25388,22278,3110,19102,16135,2967,32.907549
22/03/2018 09:29,201801,WESTERN EUROPE-EU,SPAIN(CANARY ISLANDS),ABERDEEN,TENERIFE (SURREINA SOFIA),3254,0,3254,3279,0,3279,-0.762428
22/03/2018 09:29,201801,WESTERN EUROPE-EU,SPAIN(CANARY ISLANDS),BELFAST INTERNATIONAL,ARRECIFE,11207,9499,1708,9731,8076,1655,15.16802
22/03/2018 09:29,201801,WESTERN EUROPE-EU,SPAIN(CANARY ISLANDS),BELFAST INTERNATIONAL,FUERTEVENTURA,1136,1136,0,0,0,0,0
22/03/2018 09:29,201801,WESTERN EUROPE-EU,SPAIN(CANARY ISLANDS),BELFAST INTERNATIONAL,LAS PALMAS,1432,1432,0,1560,1350,210,-8.205128
22/03/2018 09:29,201801,WESTERN EUROPE-EU,SPAIN(CANARY ISLANDS),BELFAST INTERNATIONAL,TENERIFE (SURREINA SOFIA),10380,6313,4067,9708,5414,4294,6.922126
22/03/2018 09:29,201801,WESTERN EUROPE-EU,SPAIN(CANARY ISLANDS),BIRMINGHAM,ARRECIFE,15118,11462,3656,14854,9624,5230,1.777299
22/03/2018 09:29,201801,WESTERN EUROPE-EU,SPAIN(CANARY ISLANDS),BIRMINGHAM,FUERTEVENTURA,10076,7460,2616,10221,6854,3367,-1.418648
22/03/2018 09:29,201801,WESTERN EUROPE-EU,SPAIN(CANARY ISLANDS),BIRMINGHAM,LAS PALMAS,9509,5700,3809,8348,5320,3028,13.907523
22/03/2018 09:29,201801,WESTERN EUROPE-EU,SPAIN(CANARY ISLANDS),BIRMINGHAM,TENERIFE (SURREINA SOFIA),26976,21047,5929,30998,24740,6258,-12.975031
22/03/2018 09:29,201801,WESTERN EUROPE-EU,SPAIN(CANARY ISLANDS),BOURNEMOUTH,ARRECIFE,2825,0,2825,2849,0,2849,-0.842401
22/03/2018 09:29,201801,WESTERN EUROPE-EU,SPAIN(CANARY ISLANDS),BOURNEMOUTH,LAS PALMAS,1583,0,1583,2342,964,1378,-32.408198
22/03/2018 09:29,201801,WESTERN EUROPE-EU,SPAIN(CANARY ISLANDS),BOURNEMOUTH,TENERIFE (SURREINA SOFIA),4826,1677,3149,4423,1238,3185,9.111463
22/03/2018 09:29,201801,WESTERN EUROPE-EU,SPAIN(CANARY ISLANDS),BRISTOL,ARRECIFE,15942,10506,5436,15160,11818,3342,5.158311
22/03/2018 09:29,201801,WESTERN EUROPE-EU,SPAIN(CANARY ISLANDS),BRISTOL,FUERTEVENTURA,6925,3211,3714,6216,4556,1660,11.406049
22/03/2018 09:29,201801,WESTERN EUROPE-EU,SPAIN(CANARY ISLANDS),BRISTOL,LAS PALMAS,6242,4197,2045,8910,5373,3537,-29.943883
22/03/2018 09:29,201801,WESTERN EUROPE-EU,SPAIN(CANARY ISLANDS),BRISTOL,TENERIFE (SURREINA SOFIA),17068,9489,7579,15937,12426,3511,7.096693
22/03/2018 09:29,201801,WESTERN EUROPE-EU,SPAIN(CANARY ISLANDS),CARDIFF WALES,ARRECIFE,2927,0,2927,2990,0,2990,-2.107023
22/03/2018 09:29,201801,WESTERN EUROPE-EU,SPAIN(CANARY ISLANDS),CARDIFF WALES,FUERTEVENTURA,0,0,0,183,0,183,-100
22/03/2018 09:29,201801,WESTERN EUROPE-EU,SPAIN(CANARY ISLANDS),CARDIFF WALES,LAS PALMAS,1470,0,1470,1175,0,1175,25.106383
22/03/2018 09:29,201801,WESTERN EUROPE-EU,SPAIN(CANARY ISLANDS),CARDIFF WALES,TENERIFE (SURREINA SOFIA),6360,2483,3877,7151,2445,4706,-11.06139
22/03/2018 09:29,201801,WESTERN EUROPE-EU,SPAIN(CANARY ISLANDS),DONCASTER SHEFFIELD,ARRECIFE,3051,0,3051,3316,0,3316,-7.991556
22/03/2018 09:29,201801,WESTERN EUROPE-EU,SPAIN(CANARY ISLANDS),DONCASTER SHEFFIELD,LAS PALMAS,1745,0,1745,1495,0,1495,16.722408
22/03/2018 09:29,201801,WESTERN EUROPE-EU,SPAIN(CANARY ISLANDS),DONCASTER SHEFFIELD,TENERIFE (SURREINA SOFIA),5321,0,5321,5120,0,5120,3.925781
22/03/2018 09:29,201801,WESTERN EUROPE-EU,SPAIN(CANARY ISLANDS),EAST MIDLANDS INTERNATIONAL,ARRECIFE,14984,13537,1447,17306,14282,3024,-13.417312
22/03/2018 09:29,201801,WESTERN EUROPE-EU,SPAIN(CANARY ISLANDS),EAST MIDLANDS INTERNATIONAL,FUERTEVENTURA,9595,7735,1860,10237,7401,2836,-6.271369
22/03/2018 09:29,201801,WESTERN EUROPE-EU,SPAIN(CANARY ISLANDS),EAST MIDLANDS INTERNATIONAL,LAS PALMAS,7172,5743,1429,6991,4306,2685,2.589043
22/03/2018 09:29,201801,WESTERN EUROPE-EU,SPAIN(CANARY ISLANDS),EAST MIDLANDS INTERNATIONAL,TENERIFE (SURREINA SOFIA),26134,23376,2758,24794,20397,4397,5.404533
22/03/2018 09:29,201801,WESTERN EUROPE-EU,SPAIN(CANARY ISLANDS),EDINBURGH,ARRECIFE,7791,7251,540,7626,6218,1408,2.163651
22/03/2018 09:29,201801,WESTERN EUROPE-EU,SPAIN(CANARY ISLANDS),EDINBURGH,FUERTEVENTURA,5517,5517,0,3248,3248,0,69.858374
22/03/2018 09:29,201801,WESTERN EUROPE-EU,SPAIN(CANARY ISLANDS),EDINBURGH,LAS PALMAS,5894,5148,746,5274,3982,1292,11.755783
22/03/2018 09:29,201801,WESTERN EUROPE-EU,SPAIN(CANARY ISLANDS),EDINBURGH,TENERIFE (SURREINA SOFIA),22281,19002,3279,20064,16779,3285,11.049641
22/03/2018 09:29,201801,WESTERN EUROPE-EU,SPAIN(CANARY ISLANDS),EXETER,ARRECIFE,2893,0,2893,2999,0,2999,-3.534512
22/03/2018 09:29,201801,WESTERN EUROPE-EU,SPAIN(CANARY ISLANDS),EXETER,LAS PALMAS,1648,0,1648,1423,0,1423,15.811665
22/03/2018 09:29,201801,WESTERN EUROPE-EU,SPAIN(CANARY ISLANDS),EXETER,TENERIFE (SURREINA SOFIA),4812,0,4812,3947,0,3947,21.915379
22/03/2018 09:29,201801,WESTERN EUROPE-EU,SPAIN(CANARY ISLANDS),GLASGOW,ARRECIFE,15423,13590,1833,15535,7418,8117,-0.720953
22/03/2018 09:29,201801,WESTERN EUROPE-EU,SPAIN(CANARY ISLANDS),GLASGOW,FUERTEVENTURA,7082,7082,0,6617,1246,5371,7.027354
22/03/2018 09:29,201801,WESTERN EUROPE-EU,SPAIN(CANARY ISLANDS),GLASGOW,LAS PALMAS,7742,5998,1744,8904,3946,4958,-13.050314
22/03/2018 09:29,201801,WESTERN EUROPE-EU,SPAIN(CANARY ISLANDS),GLASGOW,TENERIFE (SURREINA SOFIA),22431,19636,2795,24911,7188,17723,-9.955441
22/03/2018 09:29,201801,WESTERN EUROPE-EU,SPAIN(CANARY ISLANDS),HUMBERSIDE,TENERIFE (SURREINA SOFIA),0,0,0,1487,0,1487,-100
22/03/2018 09:29,201801,WESTERN EUROPE-EU,SPAIN(CANARY ISLANDS),JERSEY,TENERIFE (SURREINA SOFIA),0,0,0,215,0,215,-100
22/03/2018 09:29,201801,WESTERN EUROPE-EU,SPAIN(CANARY ISLANDS),LEEDS BRADFORD,ARRECIFE,9680,9680,0,9248,9248,0,4.67128
22/03/2018 09:29,201801,WESTERN EUROPE-EU,SPAIN(CANARY ISLANDS),LEEDS BRADFORD,FUERTEVENTURA,5927,5927,0,4093,4093,0,44.808209
22/03/2018 09:29,201801,WESTERN EUROPE-EU,SPAIN(CANARY ISLANDS),LEEDS BRADFORD,LAS PALMAS,4946,4946,0,4872,4872,0,1.518883
22/03/2018 09:29,201801,WESTERN EUROPE-EU,SPAIN(CANARY ISLANDS),LEEDS BRADFORD,TENERIFE (SURREINA SOFIA),13183,12994,189,13553,12389,1164,-2.730023
22/03/2018 09:29,201801,WESTERN EUROPE-EU,SPAIN(CANARY ISLANDS),LIVERPOOL (JOHN LENNON),ARRECIFE,6373,6373,0,6922,6922,0,-7.931234
22/03/2018 09:29,201801,WESTERN EUROPE-EU,SPAIN(CANARY ISLANDS),LIVERPOOL (JOHN LENNON),FUERTEVENTURA,4466,4466,0,4199,4199,0,6.358657
22/03/2018 09:29,201801,WESTERN EUROPE-EU,SPAIN(CANARY ISLANDS),LIVERPOOL (JOHN LENNON),LAS PALMAS,0,0,0,972,972,0,-100
22/03/2018 09:29,201801,WESTERN EUROPE-EU,SPAIN(CANARY ISLANDS),LIVERPOOL (JOHN LENNON),TENERIFE (SURREINA SOFIA),1707,1707,0,2191,2191,0,-22.09037
22/03/2018 09:29,201801,WESTERN EUROPE-EU,SPAIN(CANARY ISLANDS),MANCHESTER,ARRECIFE,30431,21221,9210,30266,22484,7782,0.545166
22/03/2018 09:29,201801,WESTERN EUROPE-EU,SPAIN(CANARY ISLANDS),MANCHESTER,FUERTEVENTURA,18648,12941,5707,19185,14976,4209,-2.799062
22/03/2018 09:29,201801,WESTERN EUROPE-EU,SPAIN(CANARY ISLANDS),MANCHESTER,LAS PALMAS,22996,16125,6871,22573,16008,6565,1.87392
22/03/2018 09:29,201801,WESTERN EUROPE-EU,SPAIN(CANARY ISLANDS),MANCHESTER,SANTA CRUZ DE LA PALMA,2798,0,2798,2860,0,2860,-2.167832
22/03/2018 09:29,201801,WESTERN EUROPE-EU,SPAIN(CANARY ISLANDS),MANCHESTER,TENERIFE (SURREINA SOFIA),56290,41972,14318,67348,52911,14437,-16.419196
22/03/2018 09:29,201801,WESTERN EUROPE-EU,SPAIN(CANARY ISLANDS),NEWCASTLE,ARRECIFE,10193,10193,0,9252,9252,0,10.170774
22/03/2018 09:29,201801,WESTERN EUROPE-EU,SPAIN(CANARY ISLANDS),NEWCASTLE,FUERTEVENTURA,5241,5076,165,3252,3252,0,61.162362
22/03/2018 09:29,201801,WESTERN EUROPE-EU,SPAIN(CANARY ISLANDS),NEWCASTLE,LAS PALMAS,4392,4228,164,6351,6351,0,-30.845536
22/03/2018 09:29,201801,WESTERN EUROPE-EU,SPAIN(CANARY ISLANDS),NEWCASTLE,TENERIFE (SURREINA SOFIA),21437,21437,0,20232,20232,0,5.955911
22/03/2018 09:29,201801,WESTERN EUROPE-EU,SPAIN(CANARY ISLANDS),NORWICH,TENERIFE (NORTE LOS RODEOS),2468,0,2468,0,0,0,0
22/03/2018 09:29,201801,WESTERN EUROPE-EU,SPAIN(CANARY ISLANDS),PRESTWICK,ARRECIFE,2676,2676,0,2920,2920,0,-8.356164
22/03/2018 09:29,201801,WESTERN EUROPE-EU,SPAIN(CANARY ISLANDS),PRESTWICK,FUERTEVENTURA,1241,1241,0,1487,1487,0,-16.543376
22/03/2018 09:29,201801,WESTERN EUROPE-EU,SPAIN(CANARY ISLANDS),PRESTWICK,LAS PALMAS,1144,1144,0,1161,1161,0,-1.464255
22/03/2018 09:29,201801,WESTERN EUROPE-EU,SPAIN(CANARY ISLANDS),PRESTWICK,TENERIFE (SURREINA SOFIA),5577,5577,0,5497,5497,0,1.455339
22/03/2018 09:29,201801,WESTERN EUROPE-EU,SWEDEN,GATWICK,GOTEBORG (LANDVETTER),13436,13436,0,13920,13920,0,-3.477011
22/03/2018 09:29,201801,WESTERN EUROPE-EU,SWEDEN,GATWICK,KIRUNA,101,0,101,312,0,312,-67.628205
22/03/2018 09:29,201801,WESTERN EUROPE-EU,SWEDEN,GATWICK,OSTERSUND / FROSON,1287,1287,0,858,858,0,50
22/03/2018 09:29,201801,WESTERN EUROPE-EU,SWEDEN,GATWICK,STOCKHOLM (ARLANDA),35283,35283,0,38087,38087,0,-7.362092
22/03/2018 09:29,201801,WESTERN EUROPE-EU,SWEDEN,HEATHROW,GOTEBORG (LANDVETTER),19211,19211,0,21508,21508,0,-10.679747
22/03/2018 09:29,201801,WESTERN EUROPE-EU,SWEDEN,HEATHROW,KIRUNA,563,0,563,542,0,542,3.874539
22/03/2018 09:29,201801,WESTERN EUROPE-EU,SWEDEN,HEATHROW,STOCKHOLM (ARLANDA),54323,54323,0,75169,75169,0,-27.732177
22/03/2018 09:29,201801,WESTERN EUROPE-EU,SWEDEN,LUTON,STOCKHOLM (ARLANDA),3026,3026,0,0,0,0,0
22/03/2018 09:29,201801,WESTERN EUROPE-EU,SWEDEN,STANSTED,GOTEBORG (LANDVETTER),12287,12216,71,12443,12149,294,-1.253717
22/03/2018 09:29,201801,WESTERN EUROPE-EU,SWEDEN,STANSTED,STOCKHOLM (ARLANDA),692,0,692,563,0,563,22.912966
22/03/2018 09:29,201801,WESTERN EUROPE-EU,SWEDEN,STANSTED,STOCKHOLM (SKAVSTA),19972,19972,0,16989,16989,0,17.55842
22/03/2018 09:29,201801,WESTERN EUROPE-EU,SWEDEN,STANSTED,VASTERAS,5851,5851,0,5551,5551,0,5.404432
22/03/2018 09:29,201801,WESTERN EUROPE-EU,SWEDEN,BIRMINGHAM,GOTEBORG (LANDVETTER),1200,1200,0,0,0,0,0
22/03/2018 09:29,201801,WESTERN EUROPE-EU,SWEDEN,BIRMINGHAM,KIRUNA,53,0,53,0,0,0,0
22/03/2018 09:29,201801,WESTERN EUROPE-EU,SWEDEN,BOURNEMOUTH,KIRUNA,0,0,0,79,0,79,-100
22/03/2018 09:29,201801,WESTERN EUROPE-EU,SWEDEN,BRISTOL,GOTEBORG (LANDVETTER),63,63,0,0,0,0,0
22/03/2018 09:29,201801,WESTERN EUROPE-EU,SWEDEN,BRISTOL,STOCKHOLM (ARLANDA),1992,1992,0,0,0,0,0
22/03/2018 09:29,201801,WESTERN EUROPE-EU,SWEDEN,CAMBRIDGE,GOTEBORG (LANDVETTER),10,10,0,0,0,0,0
22/03/2018 09:29,201801,WESTERN EUROPE-EU,SWEDEN,EAST MIDLANDS INTERNATIONAL,KIRUNA,0,0,0,122,0,122,-100
22/03/2018 09:29,201801,WESTERN EUROPE-EU,SWEDEN,EDINBURGH,STOCKHOLM (ARLANDA),5964,5964,0,2816,2816,0,111.789773
22/03/2018 09:29,201801,WESTERN EUROPE-EU,SWEDEN,HUMBERSIDE,KIRUNA,0,0,0,34,0,34,-100
22/03/2018 09:29,201801,WESTERN EUROPE-EU,SWEDEN,LEEDS BRADFORD,KIRUNA,0,0,0,64,0,64,-100
22/03/2018 09:29,201801,WESTERN EUROPE-EU,SWEDEN,MANCHESTER,GOTEBORG (LANDVETTER),239,239,0,0,0,0,0
22/03/2018 09:29,201801,WESTERN EUROPE-EU,SWEDEN,MANCHESTER,KIRUNA,0,0,0,77,0,77,-100
22/03/2018 09:29,201801,WESTERN EUROPE-EU,SWEDEN,MANCHESTER,STOCKHOLM (ARLANDA),10373,10373,0,11703,11703,0,-11.364607
22/03/2018 09:29,201801,WESTERN EUROPE-EU,SWEDEN,NEWCASTLE,KIRUNA,0,0,0,83,0,83,-100
22/03/2018 09:29,201801,WESTERN EUROPE-OTHER,BOSNIA-HERZEGOVINA,LUTON,TUZLA,0,0,0,1521,1521,0,-100
22/03/2018 09:29,201801,WESTERN EUROPE-OTHER,FAROE ISLANDS,EDINBURGH,VAGAR,94,94,0,111,111,0,-15.315315
22/03/2018 09:29,201801,WESTERN EUROPE-OTHER,ICELAND,GATWICK,KEFLAVIK,41696,38425,3271,45075,41739,3336,-7.496395
22/03/2018 09:29,201801,WESTERN EUROPE-OTHER,ICELAND,HEATHROW,KEFLAVIK,26790,26790,0,26571,26571,0,0.824207
22/03/2018 09:29,201801,WESTERN EUROPE-OTHER,ICELAND,LONDON CITY,KEFLAVIK,828,828,0,0,0,0,0
22/03/2018 09:29,201801,WESTERN EUROPE-OTHER,ICELAND,LUTON,KEFLAVIK,20468,20468,0,14479,14479,0,41.363354
22/03/2018 09:29,201801,WESTERN EUROPE-OTHER,ICELAND,STANSTED,KEFLAVIK,3561,3561,0,4284,4284,0,-16.876751
22/03/2018 09:29,201801,WESTERN EUROPE-OTHER,ICELAND,ABERDEEN,KEFLAVIK,538,538,0,575,575,0,-6.434783
22/03/2018 09:29,201801,WESTERN EUROPE-OTHER,ICELAND,BELFAST CITY (GEORGE BEST),KEFLAVIK,502,502,0,0,0,0,0
22/03/2018 09:29,201801,WESTERN EUROPE-OTHER,ICELAND,BELFAST INTERNATIONAL,KEFLAVIK,2603,2603,0,2615,2615,0,-0.458891
22/03/2018 09:29,201801,WESTERN EUROPE-OTHER,ICELAND,BIRMINGHAM,KEFLAVIK,1438,1438,0,3101,3101,0,-53.627862
22/03/2018 09:29,201801,WESTERN EUROPE-OTHER,ICELAND,BOURNEMOUTH,AKUREYRI,332,0,332,0,0,0,0
22/03/2018 09:29,201801,WESTERN EUROPE-OTHER,ICELAND,BRISTOL,KEFLAVIK,3077,3077,0,6549,6549,0,-53.015728
22/03/2018 09:29,201801,WESTERN EUROPE-OTHER,ICELAND,CARDIFF WALES,AKUREYRI,369,0,369,0,0,0,0
22/03/2018 09:29,201801,WESTERN EUROPE-OTHER,ICELAND,EAST MIDLANDS INTERNATIONAL,KEFLAVIK,551,0,551,548,0,548,0.547445
22/03/2018 09:29,201801,WESTERN EUROPE-OTHER,ICELAND,EDINBURGH,AKUREYRI,233,0,233,0,0,0,0
22/03/2018 09:29,201801,WESTERN EUROPE-OTHER,ICELAND,EDINBURGH,KEFLAVIK,11006,11006,0,9474,9474,0,16.170572
22/03/2018 09:29,201801,WESTERN EUROPE-OTHER,ICELAND,EXETER,AKUREYRI,374,0,374,0,0,0,0
22/03/2018 09:29,201801,WESTERN EUROPE-OTHER,ICELAND,GLASGOW,KEFLAVIK,5176,5176,0,5507,5507,0,-6.010532
22/03/2018 09:29,201801,WESTERN EUROPE-OTHER,ICELAND,HUMBERSIDE,AKUREYRI,366,0,366,0,0,0,0
22/03/2018 09:29,201801,WESTERN EUROPE-OTHER,ICELAND,MANCHESTER,KEFLAVIK,26167,22885,3282,22430,19113,3317,16.660722
22/03/2018 09:29,201801,WESTERN EUROPE-OTHER,ICELAND,NEWCASTLE,AKUREYRI,182,182,0,0,0,0,0
22/03/2018 09:29,201801,WESTERN EUROPE-OTHER,KOSOVO,GATWICK,PRISTINA,430,430,0,965,965,0,-55.440415
22/03/2018 09:29,201801,WESTERN EUROPE-OTHER,KOSOVO,LUTON,PRISTINA,3125,3125,0,0,0,0,0
22/03/2018 09:29,201801,WESTERN EUROPE-OTHER,MACEDONIA,LUTON,OHRID,0,0,0,797,797,0,-100
22/03/2018 09:29,201801,WESTERN EUROPE-OTHER,MACEDONIA,LUTON,SKOPJE,4536,4536,0,4869,4869,0,-6.839187
22/03/2018 09:29,201801,WESTERN EUROPE-OTHER,NORWAY,GATWICK,BERGEN,14890,14744,146,12917,12712,205,15.274445
22/03/2018 09:29,201801,WESTERN EUROPE-OTHER,NORWAY,GATWICK,FAGERNES/LEIRIN,1005,0,1005,1458,0,1458,-31.069959
22/03/2018 09:29,201801,WESTERN EUROPE-OTHER,NORWAY,GATWICK,HAUGESUND,0,0,0,723,0,723,-100
22/03/2018 09:29,201801,WESTERN EUROPE-OTHER,NORWAY,GATWICK,OSLO (GARDERMOEN),36180,36180,0,30230,30230,0,19.682435
22/03/2018 09:29,201801,WESTERN EUROPE-OTHER,NORWAY,GATWICK,STAVANGER,8482,8482,0,5169,5169,0,64.093635
22/03/2018 09:29,201801,WESTERN EUROPE-OTHER,NORWAY,GATWICK,TROMSOE,4211,4211,0,4337,4337,0,-2.905234
22/03/2018 09:29,201801,WESTERN EUROPE-OTHER,NORWAY,GATWICK,TRONDHEIM (VAERNES),5149,5149,0,4674,4674,0,10.162602
22/03/2018 09:29,201801,WESTERN EUROPE-OTHER,NORWAY,HEATHROW,BERGEN,0,0,0,5582,5582,0,-100
22/03/2018 09:29,201801,WESTERN EUROPE-OTHER,NORWAY,HEATHROW,OSLO (GARDERMOEN),47360,47360,0,50776,50776,0,-6.727588
22/03/2018 09:29,201801,WESTERN EUROPE-OTHER,NORWAY,HEATHROW,STAVANGER,4185,4185,0,9425,9425,0,-55.596817
22/03/2018 09:29,201801,WESTERN EUROPE-OTHER,NORWAY,STANSTED,BERGEN,0,0,0,110,0,110,-100
22/03/2018 09:29,201801,WESTERN EUROPE-OTHER,NORWAY,STANSTED,OSLO (GARDERMOEN),23445,23445,0,24471,24471,0,-4.192718
22/03/2018 09:29,201801,WESTERN EUROPE-OTHER,NORWAY,STANSTED,SANDEFJORD(TORP),3404,3404,0,0,0,0,0
22/03/2018 09:29,201801,WESTERN EUROPE-OTHER,NORWAY,ABERDEEN,BERGEN,2914,2914,0,2282,2282,0,27.695004
22/03/2018 09:29,201801,WESTERN EUROPE-OTHER,NORWAY,ABERDEEN,HAUGESUND,33,0,33,0,0,0,0
22/03/2018 09:29,201801,WESTERN EUROPE-OTHER,NORWAY,ABERDEEN,OSLO (GARDERMOEN),1449,1449,0,1805,1805,0,-19.722992
22/03/2018 09:29,201801,WESTERN EUROPE-OTHER,NORWAY,ABERDEEN,STAVANGER,5960,5960,0,5958,5958,0,0.033568
22/03/2018 09:29,201801,WESTERN EUROPE-OTHER,NORWAY,EDINBURGH,OSLO (GARDERMOEN),6178,6178,0,4121,4121,0,49.915069
22/03/2018 09:29,201801,WESTERN EUROPE-OTHER,NORWAY,MANCHESTER,BERGEN,148,0,148,282,0,282,-47.51773
22/03/2018 09:29,201801,WESTERN EUROPE-OTHER,NORWAY,MANCHESTER,OSLO (GARDERMOEN),8697,8697,0,8152,8152,0,6.685476
22/03/2018 09:29,201801,WESTERN EUROPE-OTHER,NORWAY,MANCHESTER,SANDEFJORD(TORP),5343,5343,0,5694,5694,0,-6.164384
22/03/2018 09:29,201801,WESTERN EUROPE-OTHER,NORWAY,MANCHESTER,STAVANGER,1679,1679,0,1964,1964,0,-14.511202
22/03/2018 09:29,201801,WESTERN EUROPE-OTHER,NORWAY,NEWCASTLE,STAVANGER,615,615,0,534,534,0,15.168539
22/03/2018 09:29,201801,WESTERN EUROPE-OTHER,REPUBLIC OF MONTENEGRO,STANSTED,PODGORICA,3126,3126,0,3152,3152,0,-0.824873
22/03/2018 09:29,201801,WESTERN EUROPE-OTHER,REPUBLIC OF SERBIA,HEATHROW,BELGRADE,5679,5679,0,6198,6198,0,-8.373669
22/03/2018 09:29,201801,WESTERN EUROPE-OTHER,REPUBLIC OF SERBIA,LUTON,BELGRADE,4201,4201,0,3182,3182,0,32.023884
22/03/2018 09:29,201801,WESTERN EUROPE-OTHER,SWITZERLAND,GATWICK,BALE MULHOUSE,18153,18153,0,14952,14952,0,21.408507
22/03/2018 09:29,201801,WESTERN EUROPE-OTHER,SWITZERLAND,GATWICK,GENEVA,105181,97665,7516,103771,98071,5700,1.358761
22/03/2018 09:29,201801,WESTERN EUROPE-OTHER,SWITZERLAND,GATWICK,ZURICH,12863,12683,180,13446,13446,0,-4.335862
22/03/2018 09:29,201801,WESTERN EUROPE-OTHER,SWITZERLAND,HEATHROW,BALE MULHOUSE,19506,19506,0,17432,17432,0,11.897659
22/03/2018 09:29,201801,WESTERN EUROPE-OTHER,SWITZERLAND,HEATHROW,GENEVA,96945,96945,0,102050,101010,1040,-5.00245
22/03/2018 09:29,201801,WESTERN EUROPE-OTHER,SWITZERLAND,HEATHROW,SION,488,488,0,0,0,0,0
22/03/2018 09:29,201801,WESTERN EUROPE-OTHER,SWITZERLAND,HEATHROW,ZURICH,90500,90500,0,85529,85529,0,5.812064
22/03/2018 09:29,201801,WESTERN EUROPE-OTHER,SWITZERLAND,LONDON CITY,BALE MULHOUSE,0,0,0,1483,1483,0,-100
22/03/2018 09:29,201801,WESTERN EUROPE-OTHER,SWITZERLAND,LONDON CITY,BERNE,475,475,0,1210,1210,0,-60.743802
22/03/2018 09:29,201801,WESTERN EUROPE-OTHER,SWITZERLAND,LONDON CITY,GENEVA,17918,17918,0,17522,17522,0,2.260016
22/03/2018 09:29,201801,WESTERN EUROPE-OTHER,SWITZERLAND,LONDON CITY,ZURICH,32457,32457,0,30658,30658,0,5.867963
22/03/2018 09:29,201801,WESTERN EUROPE-OTHER,SWITZERLAND,LUTON,BALE MULHOUSE,4531,4531,0,3541,3541,0,27.958204
22/03/2018 09:29,201801,WESTERN EUROPE-OTHER,SWITZERLAND,LUTON,GENEVA,43524,43524,0,36045,36045,0,20.749064
22/03/2018 09:29,201801,WESTERN EUROPE-OTHER,SWITZERLAND,LUTON,ZURICH,11409,11409,0,12982,12980,2,-12.116777
22/03/2018 09:29,201801,WESTERN EUROPE-OTHER,SWITZERLAND,SOUTHEND,GENEVA,7100,7100,0,6628,6628,0,7.121304
22/03/2018 09:29,201801,WESTERN EUROPE-OTHER,SWITZERLAND,STANSTED,BALE MULHOUSE,6412,6412,0,6639,6639,0,-3.41919
22/03/2018 09:29,201801,WESTERN EUROPE-OTHER,SWITZERLAND,STANSTED,GENEVA,18847,18847,0,15742,14658,1084,19.724304
22/03/2018 09:29,201801,WESTERN EUROPE-OTHER,SWITZERLAND,STANSTED,ZURICH,90,0,90,99,99,0,-9.090909
22/03/2018 09:29,201801,WESTERN EUROPE-OTHER,SWITZERLAND,ABERDEEN,GENEVA,1860,1860,0,1384,1384,0,34.393064
22/03/2018 09:29,201801,WESTERN EUROPE-OTHER,SWITZERLAND,BELFAST INTERNATIONAL,GENEVA,5190,5190,0,4939,4939,0,5.082
22/03/2018 09:29,201801,WESTERN EUROPE-OTHER,SWITZERLAND,BIRMINGHAM,GENEVA,21673,20548,1125,17249,16141,1108,25.647864
22/03/2018 09:29,201801,WESTERN EUROPE-OTHER,SWITZERLAND,BIRMINGHAM,ZURICH,8339,8339,0,8141,8141,0,2.432134
22/03/2018 09:29,201801,WESTERN EUROPE-OTHER,SWITZERLAND,BOURNEMOUTH,GENEVA,6094,6094,0,6787,6787,0,-10.210697
22/03/2018 09:29,201801,WESTERN EUROPE-OTHER,SWITZERLAND,BRISTOL,BALE MULHOUSE,2360,2360,0,2611,2611,0,-9.613175
22/03/2018 09:29,201801,WESTERN EUROPE-OTHER,SWITZERLAND,BRISTOL,GENEVA,32897,29553,3344,31084,29397,1687,5.832583
22/03/2018 09:29,201801,WESTERN EUROPE-OTHER,SWITZERLAND,CARDIFF WALES,GENEVA,779,779,0,956,956,0,-18.514644
22/03/2018 09:29,201801,WESTERN EUROPE-OTHER,SWITZERLAND,EAST MIDLANDS INTERNATIONAL,GENEVA,2909,2909,0,4042,4042,0,-28.030678
22/03/2018 09:29,201801,WESTERN EUROPE-OTHER,SWITZERLAND,EDINBURGH,BALE MULHOUSE,3501,3501,0,3184,3184,0,9.95603
22/03/2018 09:29,201801,WESTERN EUROPE-OTHER,SWITZERLAND,EDINBURGH,GENEVA,21823,20342,1481,20327,18986,1341,7.359669
22/03/2018 09:29,201801,WESTERN EUROPE-OTHER,SWITZERLAND,EDINBURGH,ZURICH,444,444,0,0,0,0,0
22/03/2018 09:29,201801,WESTERN EUROPE-OTHER,SWITZERLAND,EXETER,GENEVA,565,565,0,1176,1176,0,-51.955782
22/03/2018 09:29,201801,WESTERN EUROPE-OTHER,SWITZERLAND,GLASGOW,GENEVA,3467,3467,0,4600,4600,0,-24.630435
22/03/2018 09:29,201801,WESTERN EUROPE-OTHER,SWITZERLAND,INVERNESS,GENEVA,0,0,0,780,780,0,-100
22/03/2018 09:29,201801,WESTERN EUROPE-OTHER,SWITZERLAND,ISLE OF MAN,GENEVA,499,0,499,469,0,469,6.396588
22/03/2018 09:29,201801,WESTERN EUROPE-OTHER,SWITZERLAND,JERSEY,GENEVA,485,485,0,543,543,0,-10.6814
22/03/2018 09:29,201801,WESTERN EUROPE-OTHER,SWITZERLAND,LEEDS BRADFORD,GENEVA,7557,7557,0,10066,10066,0,-24.925492
22/03/2018 09:29,201801,WESTERN EUROPE-OTHER,SWITZERLAND,LIVERPOOL (JOHN LENNON),GENEVA,19065,19065,0,19415,19415,0,-1.80273
22/03/2018 09:29,201801,WESTERN EUROPE-OTHER,SWITZERLAND,LIVERPOOL (JOHN LENNON),SION,0,0,0,30,0,30,-100
22/03/2018 09:29,201801,WESTERN EUROPE-OTHER,SWITZERLAND,MANCHESTER,BALE MULHOUSE,4911,4911,0,5124,5124,0,-4.156909
22/03/2018 09:29,201801,WESTERN EUROPE-OTHER,SWITZERLAND,MANCHESTER,GENEVA,32084,29433,2651,31580,29887,1693,1.595947
22/03/2018 09:29,201801,WESTERN EUROPE-OTHER,SWITZERLAND,MANCHESTER,ZURICH,11561,11561,0,12346,12346,0,-6.358335
22/03/2018 09:29,201801,WESTERN EUROPE-OTHER,SWITZERLAND,NEWCASTLE,GENEVA,9325,9325,0,8887,8887,0,4.928547
22/03/2018 09:29,201801,WESTERN EUROPE-OTHER,SWITZERLAND,SOUTHAMPTON,GENEVA,4697,4697,0,1491,1491,0,215.023474
22/03/2018 09:29,201801,WESTERN EUROPE-OTHER,TURKEY,GATWICK,ANTALYA,2730,2471,259,440,319,121,520.454545
22/03/2018 09:29,201801,WESTERN EUROPE-OTHER,TURKEY,GATWICK,DALAMAN,518,518,0,0,0,0,0
22/03/2018 09:29,201801,WESTERN EUROPE-OTHER,TURKEY,GATWICK,ISTANBUL,19384,19384,0,12396,12396,0,56.373024
22/03/2018 09:29,201801,WESTERN EUROPE-OTHER,TURKEY,GATWICK,ISTANBUL (SABIHA GOKCEN),5955,5955,0,13422,13422,0,-55.632544
22/03/2018 09:29,201801,WESTERN EUROPE-OTHER,TURKEY,HEATHROW,ISTANBUL,79437,79437,0,64820,64820,0,22.550139
22/03/2018 09:29,201801,WESTERN EUROPE-OTHER,TURKEY,LUTON,ANTALYA,0,0,0,184,184,0,-100
22/03/2018 09:29,201801,WESTERN EUROPE-OTHER,TURKEY,STANSTED,ANTALYA,0,0,0,1054,0,1054,-100
22/03/2018 09:29,201801,WESTERN EUROPE-OTHER,TURKEY,STANSTED,ISTANBUL,8131,8131,0,6917,6917,0,17.550961
22/03/2018 09:29,201801,WESTERN EUROPE-OTHER,TURKEY,STANSTED,ISTANBUL (SABIHA GOKCEN),29721,29721,0,15723,15723,0,89.028811
22/03/2018 09:29,201801,WESTERN EUROPE-OTHER,TURKEY,STANSTED,IZMIR (ADNAN MENDERES),3906,3906,0,2953,2953,0,32.272265
22/03/2018 09:29,201801,WESTERN EUROPE-OTHER,TURKEY,BIRMINGHAM,ANTALYA,0,0,0,157,0,157,-100
22/03/2018 09:29,201801,WESTERN EUROPE-OTHER,TURKEY,BIRMINGHAM,ISTANBUL,10063,10063,0,7847,7847,0,28.240092
22/03/2018 09:29,201801,WESTERN EUROPE-OTHER,TURKEY,EDINBURGH,ISTANBUL,5409,5409,0,4267,4267,0,26.763534
22/03/2018 09:29,201801,WESTERN EUROPE-OTHER,TURKEY,GLASGOW,ANTALYA,1367,1367,0,0,0,0,0
22/03/2018 09:29,201801,WESTERN EUROPE-OTHER,TURKEY,MANCHESTER,ANTALYA,4373,4113,260,2703,2097,606,61.783204
22/03/2018 09:29,201801,WESTERN EUROPE-OTHER,TURKEY,MANCHESTER,DALAMAN,405,405,0,0,0,0,0
22/03/2018 09:29,201801,WESTERN EUROPE-OTHER,TURKEY,MANCHESTER,ISTANBUL,19463,19463,0,14316,14316,0,35.95278
22/03/2018 09:29,201801,EASTERN EUROPE-EU,BULGARIA,GATWICK,SOFIA,15079,12284,2795,18060,15546,2514,-16.506091
22/03/2018 09:29,201801,EASTERN EUROPE-EU,BULGARIA,HEATHROW,SOFIA,13802,13802,0,11534,11534,0,19.663603
22/03/2018 09:29,201801,EASTERN EUROPE-EU,BULGARIA,LUTON,BURGAS,4274,4274,0,3758,3758,0,13.730708
22/03/2018 09:29,201801,EASTERN EUROPE-EU,BULGARIA,LUTON,SOFIA,23010,23010,0,18812,18812,0,22.315543
22/03/2018 09:29,201801,EASTERN EUROPE-EU,BULGARIA,LUTON,VARNA,8050,8050,0,6467,6467,0,24.47812
22/03/2018 09:29,201801,EASTERN EUROPE-EU,BULGARIA,STANSTED,PLOVDIV,5300,5300,0,4339,4339,0,22.14796
22/03/2018 09:29,201801,EASTERN EUROPE-EU,BULGARIA,STANSTED,SOFIA,21921,21921,0,22553,22553,0,-2.802288
22/03/2018 09:29,201801,EASTERN EUROPE-EU,BULGARIA,BELFAST INTERNATIONAL,PLOVDIV,2182,0,2182,2176,0,2176,0.275735
22/03/2018 09:29,201801,EASTERN EUROPE-EU,BULGARIA,BIRMINGHAM,SOFIA,6709,5254,1455,8589,7218,1371,-21.888462
22/03/2018 09:29,201801,EASTERN EUROPE-EU,BULGARIA,BRISTOL,SOFIA,1484,0,1484,3954,2749,1205,-62.468386
22/03/2018 09:29,201801,EASTERN EUROPE-EU,BULGARIA,DONCASTER SHEFFIELD,SOFIA,0,0,0,2249,2249,0,-100
22/03/2018 09:29,201801,EASTERN EUROPE-EU,BULGARIA,EAST MIDLANDS INTERNATIONAL,SOFIA,1131,0,1131,742,0,742,52.425876
22/03/2018 09:29,201801,EASTERN EUROPE-EU,BULGARIA,EDINBURGH,SOFIA,2591,2591,0,0,0,0,0
22/03/2018 09:29,201801,EASTERN EUROPE-EU,BULGARIA,GLASGOW,SOFIA,2787,2787,0,2707,2707,0,2.955301
22/03/2018 09:29,201801,EASTERN EUROPE-EU,BULGARIA,LIVERPOOL (JOHN LENNON),SOFIA,3091,3091,0,3182,3182,0,-2.859837
22/03/2018 09:29,201801,EASTERN EUROPE-EU,BULGARIA,MANCHESTER,SOFIA,10373,7661,2712,9844,7793,2051,5.373832
22/03/2018 09:29,201801,EASTERN EUROPE-EU,BULGARIA,NEWCASTLE,SOFIA,1088,1088,0,1004,1004,0,8.366534
22/03/2018 09:29,201801,EASTERN EUROPE-EU,CZECH REPUBLIC,GATWICK,PRAGUE,18629,18629,0,27750,27750,0,-32.868468
22/03/2018 09:29,201801,EASTERN EUROPE-EU,CZECH REPUBLIC,HEATHROW,PRAGUE,25232,25232,0,28176,28176,0,-10.448609
22/03/2018 09:29,201801,EASTERN EUROPE-EU,CZECH REPUBLIC,LONDON CITY,PRAGUE,2712,2705,7,0,0,0,0
22/03/2018 09:29,201801,EASTERN EUROPE-EU,CZECH REPUBLIC,LUTON,BRNO (TURANY),1083,1083,0,3912,3912,0,-72.315951
22/03/2018 09:29,201801,EASTERN EUROPE-EU,CZECH REPUBLIC,LUTON,PRAGUE,7576,7576,0,9441,9441,0,-19.754263
22/03/2018 09:29,201801,EASTERN EUROPE-EU,CZECH REPUBLIC,SOUTHEND,PRAGUE,2357,2357,0,0,0,0,0
22/03/2018 09:29,201801,EASTERN EUROPE-EU,CZECH REPUBLIC,STANSTED,BRNO (TURANY),7089,7089,0,7845,7845,0,-9.636711
22/03/2018 09:29,201801,EASTERN EUROPE-EU,CZECH REPUBLIC,STANSTED,OSTRAVA,5329,5329,0,6106,6106,0,-12.725188
22/03/2018 09:29,201801,EASTERN EUROPE-EU,CZECH REPUBLIC,STANSTED,PARDUBICE,3475,3475,0,0,0,0,0
22/03/2018 09:29,201801,EASTERN EUROPE-EU,CZECH REPUBLIC,STANSTED,PRAGUE,33685,33685,0,22881,22881,0,47.218216
22/03/2018 09:29,201801,EASTERN EUROPE-EU,CZECH REPUBLIC,BIRMINGHAM,PRAGUE,2328,2328,0,3286,3286,0,-29.153987
22/03/2018 09:29,201801,EASTERN EUROPE-EU,CZECH REPUBLIC,BRISTOL,PRAGUE,6151,6151,0,6211,6211,0,-0.966028
22/03/2018 09:29,201801,EASTERN EUROPE-EU,CZECH REPUBLIC,EAST MIDLANDS INTERNATIONAL,PRAGUE,226,226,0,449,255,194,-49.665924
22/03/2018 09:29,201801,EASTERN EUROPE-EU,CZECH REPUBLIC,EDINBURGH,PRAGUE,9075,9075,0,4934,4934,0,83.927848
22/03/2018 09:29,201801,EASTERN EUROPE-EU,CZECH REPUBLIC,GLASGOW,PRAGUE,544,544,0,781,722,59,-30.345711
22/03/2018 09:29,201801,EASTERN EUROPE-EU,CZECH REPUBLIC,LEEDS BRADFORD,PRAGUE,245,245,0,287,287,0,-14.634146
22/03/2018 09:29,201801,EASTERN EUROPE-EU,CZECH REPUBLIC,LIVERPOOL (JOHN LENNON),PRAGUE,5838,5838,0,0,0,0,0
22/03/2018 09:29,201801,EASTERN EUROPE-EU,CZECH REPUBLIC,MANCHESTER,PRAGUE,15795,15795,0,12515,12515,0,26.20855
22/03/2018 09:29,201801,EASTERN EUROPE-EU,CZECH REPUBLIC,NEWCASTLE,PRAGUE,476,476,0,424,424,0,12.264151
22/03/2018 09:29,201801,EASTERN EUROPE-EU,ESTONIA,GATWICK,TALLIN,2890,2890,0,2515,2515,0,14.910537
22/03/2018 09:29,201801,EASTERN EUROPE-EU,ESTONIA,HEATHROW,TALLIN,2583,2583,0,0,0,0,0
22/03/2018 09:29,201801,EASTERN EUROPE-EU,ESTONIA,STANSTED,TALLIN,6389,6389,0,6715,6715,0,-4.854803
22/03/2018 09:29,201801,EASTERN EUROPE-EU,HUNGARY,GATWICK,BUDAPEST,14448,14326,122,15799,15799,0,-8.551174
22/03/2018 09:29,201801,EASTERN EUROPE-EU,HUNGARY,HEATHROW,BUDAPEST,21291,21291,0,19516,19516,0,9.095101
22/03/2018 09:29,201801,EASTERN EUROPE-EU,HUNGARY,LUTON,BUDAPEST,36364,36364,0,41610,41610,0,-12.607546
22/03/2018 09:29,201801,EASTERN EUROPE-EU,HUNGARY,LUTON,DEBRECEN,10197,10197,0,10400,10400,0,-1.951923
22/03/2018 09:29,201801,EASTERN EUROPE-EU,HUNGARY,SOUTHEND,BUDAPEST,690,690,0,0,0,0,0
22/03/2018 09:29,201801,EASTERN EUROPE-EU,HUNGARY,STANSTED,BUDAPEST,36026,36026,0,31582,31582,0,14.071306
22/03/2018 09:29,201801,EASTERN EUROPE-EU,HUNGARY,BIRMINGHAM,BUDAPEST,3969,3969,0,3967,3967,0,0.050416
22/03/2018 09:29,201801,EASTERN EUROPE-EU,HUNGARY,BRISTOL,BUDAPEST,4677,4677,0,5170,5170,0,-9.535783
22/03/2018 09:29,201801,EASTERN EUROPE-EU,HUNGARY,EAST MIDLANDS INTERNATIONAL,BUDAPEST,3649,3649,0,276,276,0,1222.101449
22/03/2018 09:29,201801,EASTERN EUROPE-EU,HUNGARY,EDINBURGH,BUDAPEST,5534,5534,0,2451,2451,0,125.785394
22/03/2018 09:29,201801,EASTERN EUROPE-EU,HUNGARY,GLASGOW,BUDAPEST,2759,2759,0,3135,3135,0,-11.99362
22/03/2018 09:29,201801,EASTERN EUROPE-EU,HUNGARY,LEEDS BRADFORD,BUDAPEST,506,506,0,439,439,0,15.261959
22/03/2018 09:29,201801,EASTERN EUROPE-EU,HUNGARY,LIVERPOOL (JOHN LENNON),BUDAPEST,3465,3465,0,2718,2718,0,27.483444
22/03/2018 09:29,201801,EASTERN EUROPE-EU,HUNGARY,MANCHESTER,BUDAPEST,11700,11700,0,10855,10724,131,7.784431
22/03/2018 09:29,201801,EASTERN EUROPE-EU,LATVIA,GATWICK,RIGA,6997,6997,0,6006,6006,0,16.500167
22/03/2018 09:29,201801,EASTERN EUROPE-EU,LATVIA,LUTON,RIGA,15706,15706,0,13971,13971,0,12.418581
22/03/2018 09:29,201801,EASTERN EUROPE-EU,LATVIA,STANSTED,RIGA,21424,21424,0,21606,21606,0,-0.842359
22/03/2018 09:29,201801,EASTERN EUROPE-EU,LATVIA,DONCASTER SHEFFIELD,RIGA,3681,3681,0,3280,3280,0,12.22561
22/03/2018 09:29,201801,EASTERN EUROPE-EU,LATVIA,EAST MIDLANDS INTERNATIONAL,RIGA,4812,4812,0,4647,4647,0,3.550678
22/03/2018 09:29,201801,EASTERN EUROPE-EU,LATVIA,GLASGOW,RIGA,1808,1808,0,1440,1440,0,25.555556
22/03/2018 09:29,201801,EASTERN EUROPE-EU,LATVIA,LEEDS BRADFORD,RIGA,3046,3046,0,3008,3008,0,1.263298
22/03/2018 09:29,201801,EASTERN EUROPE-EU,LATVIA,LIVERPOOL (JOHN LENNON),RIGA,2815,2815,0,2700,2700,0,4.259259
22/03/2018 09:29,201801,EASTERN EUROPE-EU,LATVIA,MANCHESTER,RIGA,3591,3591,0,5359,5359,0,-32.99123
22/03/2018 09:29,201801,EASTERN EUROPE-EU,LITHUANIA,LUTON,KAUNAS,20008,20008,0,17949,17949,0,11.471391
22/03/2018 09:29,201801,EASTERN EUROPE-EU,LITHUANIA,LUTON,PALANGA,3423,3423,0,3294,3294,0,3.916211
22/03/2018 09:29,201801,EASTERN EUROPE-EU,LITHUANIA,LUTON,VILNIUS,25172,25172,0,22969,22969,0,9.591188
22/03/2018 09:29,201801,EASTERN EUROPE-EU,LITHUANIA,STANSTED,KAUNAS,8549,8549,0,7512,7512,0,13.804579
22/03/2018 09:29,201801,EASTERN EUROPE-EU,LITHUANIA,STANSTED,PALANGA,3398,3398,0,3478,3478,0,-2.300173
22/03/2018 09:29,201801,EASTERN EUROPE-EU,LITHUANIA,STANSTED,VILNIUS,11347,11347,0,11347,11347,0,0
22/03/2018 09:29,201801,EASTERN EUROPE-EU,LITHUANIA,BELFAST INTERNATIONAL,VILNIUS,2878,2878,0,2795,2795,0,2.969589
22/03/2018 09:29,201801,EASTERN EUROPE-EU,LITHUANIA,BIRMINGHAM,VILNIUS,3347,3347,0,3287,3287,0,1.825373
22/03/2018 09:29,201801,EASTERN EUROPE-EU,LITHUANIA,BRISTOL,KAUNAS,3420,3420,0,3648,3648,0,-6.25
22/03/2018 09:29,201801,EASTERN EUROPE-EU,LITHUANIA,DONCASTER SHEFFIELD,VILNIUS,3361,3361,0,3363,3363,0,-0.059471
22/03/2018 09:29,201801,EASTERN EUROPE-EU,LITHUANIA,LEEDS BRADFORD,VILNIUS,2855,2855,0,2778,2778,0,2.771778
22/03/2018 09:29,201801,EASTERN EUROPE-EU,LITHUANIA,LIVERPOOL (JOHN LENNON),VILNIUS,3046,3046,0,3078,3078,0,-1.039636
22/03/2018 09:29,201801,EASTERN EUROPE-EU,POLAND,GATWICK,KRAKOW,12202,12202,0,11231,11231,0,8.645713
22/03/2018 09:29,201801,EASTERN EUROPE-EU,POLAND,GATWICK,WARSAW (CHOPIN),0,0,0,5422,5422,0,-100
22/03/2018 09:29,201801,EASTERN EUROPE-EU,POLAND,HEATHROW,KRAKOW,5585,5585,0,5976,5976,0,-6.542838
22/03/2018 09:29,201801,EASTERN EUROPE-EU,POLAND,HEATHROW,WARSAW (CHOPIN),34350,34350,0,29177,29177,0,17.729719
22/03/2018 09:29,201801,EASTERN EUROPE-EU,POLAND,LUTON,BYDGOSZCZ,4182,4182,0,0,0,0,0
22/03/2018 09:29,201801,EASTERN EUROPE-EU,POLAND,LUTON,GDANSK,24503,24503,0,17915,17915,0,36.773653
22/03/2018 09:29,201801,EASTERN EUROPE-EU,POLAND,LUTON,KATOWICE,28341,28341,0,23499,23499,0,20.605132
22/03/2018 09:29,201801,EASTERN EUROPE-EU,POLAND,LUTON,LUBLIN (PORT LOTNICZY),8436,8436,0,8003,8003,0,5.410471
22/03/2018 09:29,201801,EASTERN EUROPE-EU,POLAND,LUTON,POZNAN,13040,13040,0,12983,12983,0,0.439036
22/03/2018 09:29,201801,EASTERN EUROPE-EU,POLAND,LUTON,RZESZOW,5262,5262,0,4866,4866,0,8.138101
22/03/2018 09:29,201801,EASTERN EUROPE-EU,POLAND,LUTON,SZCZECIN (GOLENOW),1556,1556,0,3681,3681,0,-57.728878
22/03/2018 09:29,201801,EASTERN EUROPE-EU,POLAND,LUTON,SZYMANY (MAZURY),2030,2030,0,2634,2634,0,-22.930904
22/03/2018 09:29,201801,EASTERN EUROPE-EU,POLAND,LUTON,WARSAW (CHOPIN),36622,36622,0,33571,33571,0,9.088201
22/03/2018 09:29,201801,EASTERN EUROPE-EU,POLAND,LUTON,WROCLAW,9423,9423,0,9440,9440,0,-0.180085
22/03/2018 09:29,201801,EASTERN EUROPE-EU,POLAND,STANSTED,BYDGOSZCZ,8603,8603,0,9095,9095,0,-5.409566
22/03/2018 09:29,201801,EASTERN EUROPE-EU,POLAND,STANSTED,GDANSK,15961,15961,0,18035,18035,0,-11.499861
22/03/2018 09:29,201801,EASTERN EUROPE-EU,POLAND,STANSTED,KATOWICE,11272,11272,0,11066,11066,0,1.861558
22/03/2018 09:29,201801,EASTERN EUROPE-EU,POLAND,STANSTED,KRAKOW,28337,28337,0,28692,28692,0,-1.237279
22/03/2018 09:29,201801,EASTERN EUROPE-EU,POLAND,STANSTED,LODZ LUBLINEK,8919,8919,0,8895,8895,0,0.269815
22/03/2018 09:29,201801,EASTERN EUROPE-EU,POLAND,STANSTED,LUBLIN (PORT LOTNICZY),6107,6107,0,5075,5075,0,20.334975
22/03/2018 09:29,201801,EASTERN EUROPE-EU,POLAND,STANSTED,POZNAN,12325,12325,0,11150,11150,0,10.538117
22/03/2018 09:29,201801,EASTERN EUROPE-EU,POLAND,STANSTED,RZESZOW,8615,8615,0,8528,8528,0,1.020169
22/03/2018 09:29,201801,EASTERN EUROPE-EU,POLAND,STANSTED,SZCZECIN (GOLENOW),7443,7443,0,7542,7542,0,-1.312649
22/03/2018 09:29,201801,EASTERN EUROPE-EU,POLAND,STANSTED,SZYMANY (MAZURY),4082,4082,0,3910,3910,0,4.398977
22/03/2018 09:29,201801,EASTERN EUROPE-EU,POLAND,STANSTED,WARSAW (MODLIN MASOVIA),31044,31044,0,34530,34530,0,-10.095569
22/03/2018 09:29,201801,EASTERN EUROPE-EU,POLAND,STANSTED,WROCLAW,17093,17093,0,17991,17991,0,-4.991385
22/03/2018 09:29,201801,EASTERN EUROPE-EU,POLAND,ABERDEEN,GDANSK,3004,3004,0,2869,2869,0,4.705472
22/03/2018 09:29,201801,EASTERN EUROPE-EU,POLAND,ABERDEEN,WARSAW (CHOPIN),1852,1852,0,2847,2847,0,-34.949069
22/03/2018 09:29,201801,EASTERN EUROPE-EU,POLAND,BELFAST INTERNATIONAL,GDANSK,2962,2962,0,2433,2433,0,21.742704
22/03/2018 09:29,201801,EASTERN EUROPE-EU,POLAND,BELFAST INTERNATIONAL,KATOWICE,0,0,0,568,568,0,-100
22/03/2018 09:29,201801,EASTERN EUROPE-EU,POLAND,BELFAST INTERNATIONAL,KRAKOW,8320,8320,0,8747,8747,0,-4.881674
22/03/2018 09:29,201801,EASTERN EUROPE-EU,POLAND,BELFAST INTERNATIONAL,WARSAW (MODLIN MASOVIA),2912,2912,0,2809,2809,0,3.666785
22/03/2018 09:29,201801,EASTERN EUROPE-EU,POLAND,BELFAST INTERNATIONAL,WROCLAW,2731,2731,0,2539,2539,0,7.562032
22/03/2018 09:29,201801,EASTERN EUROPE-EU,POLAND,BIRMINGHAM,BYDGOSZCZ,4444,4444,0,4806,4806,0,-7.532251
22/03/2018 09:29,201801,EASTERN EUROPE-EU,POLAND,BIRMINGHAM,GDANSK,3307,3307,0,3137,3137,0,5.41919
22/03/2018 09:29,201801,EASTERN EUROPE-EU,POLAND,BIRMINGHAM,KATOWICE,2763,2763,0,3107,3107,0,-11.071773
22/03/2018 09:29,201801,EASTERN EUROPE-EU,POLAND,BIRMINGHAM,KRAKOW,4528,4528,0,3768,3768,0,20.169851
22/03/2018 09:29,201801,EASTERN EUROPE-EU,POLAND,BIRMINGHAM,POZNAN,2675,2675,0,2647,2647,0,1.057801
22/03/2018 09:29,201801,EASTERN EUROPE-EU,POLAND,BIRMINGHAM,RZESZOW,184,184,0,0,0,0,0
22/03/2018 09:29,201801,EASTERN EUROPE-EU,POLAND,BIRMINGHAM,WARSAW (CHOPIN),3457,3457,0,3599,3599,0,-3.94554
22/03/2018 09:29,201801,EASTERN EUROPE-EU,POLAND,BIRMINGHAM,WARSAW (MODLIN MASOVIA),4553,4553,0,4133,4133,0,10.16211
22/03/2018 09:29,201801,EASTERN EUROPE-EU,POLAND,BIRMINGHAM,WROCLAW,2570,2570,0,2592,2592,0,-0.848765
22/03/2018 09:29,201801,EASTERN EUROPE-EU,POLAND,BOURNEMOUTH,KRAKOW,2972,2972,0,3069,3069,0,-3.160639
22/03/2018 09:29,201801,EASTERN EUROPE-EU,POLAND,BRISTOL,GDANSK,3633,3633,0,3793,3793,0,-4.218297
22/03/2018 09:29,201801,EASTERN EUROPE-EU,POLAND,BRISTOL,KATOWICE,3637,3637,0,3456,3456,0,5.237269
22/03/2018 09:29,201801,EASTERN EUROPE-EU,POLAND,BRISTOL,KRAKOW,11050,11050,0,10427,10427,0,5.974873
22/03/2018 09:29,201801,EASTERN EUROPE-EU,POLAND,BRISTOL,POZNAN,3605,3605,0,2982,2982,0,20.892019
22/03/2018 09:29,201801,EASTERN EUROPE-EU,POLAND,BRISTOL,RZESZOW,2920,2920,0,3379,3379,0,-13.583901
22/03/2018 09:29,201801,EASTERN EUROPE-EU,POLAND,BRISTOL,WARSAW (CHOPIN),0,0,0,2514,2514,0,-100
22/03/2018 09:29,201801,EASTERN EUROPE-EU,POLAND,BRISTOL,WARSAW (MODLIN MASOVIA),6208,6208,0,6296,6296,0,-1.397713
22/03/2018 09:29,201801,EASTERN EUROPE-EU,POLAND,BRISTOL,WROCLAW,3625,3625,0,3371,3371,0,7.534856
22/03/2018 09:29,201801,EASTERN EUROPE-EU,POLAND,CARDIFF WALES,POZNAN,182,182,0,0,0,0,0
22/03/2018 09:29,201801,EASTERN EUROPE-EU,POLAND,DONCASTER SHEFFIELD,GDANSK,5380,5380,0,6250,6250,0,-13.92
22/03/2018 09:29,201801,EASTERN EUROPE-EU,POLAND,DONCASTER SHEFFIELD,KATOWICE,5507,5507,0,6174,6174,0,-10.803369
22/03/2018 09:29,201801,EASTERN EUROPE-EU,POLAND,DONCASTER SHEFFIELD,LUBLIN (PORT LOTNICZY),3561,3561,0,3430,3430,0,3.819242
22/03/2018 09:29,201801,EASTERN EUROPE-EU,POLAND,DONCASTER SHEFFIELD,POZNAN,3690,3690,0,4956,4956,0,-25.544794
22/03/2018 09:29,201801,EASTERN EUROPE-EU,POLAND,DONCASTER SHEFFIELD,WARSAW (CHOPIN),4109,4109,0,4180,4180,0,-1.698565
22/03/2018 09:29,201801,EASTERN EUROPE-EU,POLAND,DONCASTER SHEFFIELD,WROCLAW,3052,3052,0,3436,3436,0,-11.175786
22/03/2018 09:29,201801,EASTERN EUROPE-EU,POLAND,EAST MIDLANDS INTERNATIONAL,KRAKOW,4821,4821,0,4857,4857,0,-0.741198
22/03/2018 09:29,201801,EASTERN EUROPE-EU,POLAND,EAST MIDLANDS INTERNATIONAL,LODZ LUBLINEK,3088,3088,0,3371,3371,0,-8.395135
22/03/2018 09:29,201801,EASTERN EUROPE-EU,POLAND,EAST MIDLANDS INTERNATIONAL,RZESZOW,4371,4371,0,5397,5397,0,-19.010561
22/03/2018 09:29,201801,EASTERN EUROPE-EU,POLAND,EAST MIDLANDS INTERNATIONAL,WARSAW (MODLIN MASOVIA),4727,4727,0,4670,4670,0,1.220557
22/03/2018 09:29,201801,EASTERN EUROPE-EU,POLAND,EAST MIDLANDS INTERNATIONAL,WROCLAW,6394,6394,0,6659,6659,0,-3.979577
22/03/2018 09:29,201801,EASTERN EUROPE-EU,POLAND,EDINBURGH,GDANSK,4745,4745,0,4988,4988,0,-4.871692
22/03/2018 09:29,201801,EASTERN EUROPE-EU,POLAND,EDINBURGH,KATOWICE,2789,2789,0,0,0,0,0
22/03/2018 09:29,201801,EASTERN EUROPE-EU,POLAND,EDINBURGH,KRAKOW,8905,8905,0,10771,10771,0,-17.324297
22/03/2018 09:29,201801,EASTERN EUROPE-EU,POLAND,EDINBURGH,POZNAN,3289,3289,0,3198,3198,0,2.845528
22/03/2018 09:29,201801,EASTERN EUROPE-EU,POLAND,EDINBURGH,WARSAW (MODLIN MASOVIA),4453,4453,0,4507,4507,0,-1.198136
22/03/2018 09:29,201801,EASTERN EUROPE-EU,POLAND,EDINBURGH,WROCLAW,2838,2838,0,0,0,0,0
22/03/2018 09:29,201801,EASTERN EUROPE-EU,POLAND,GLASGOW,GDANSK,1426,1426,0,2741,2741,0,-47.975192
22/03/2018 09:29,201801,EASTERN EUROPE-EU,POLAND,GLASGOW,KATOWICE,2692,2692,0,2911,2911,0,-7.523188
22/03/2018 09:29,201801,EASTERN EUROPE-EU,POLAND,GLASGOW,KRAKOW,2952,2952,0,0,0,0,0
22/03/2018 09:29,201801,EASTERN EUROPE-EU,POLAND,GLASGOW,LUBLIN (PORT LOTNICZY),0,0,0,1640,1640,0,-100
22/03/2018 09:29,201801,EASTERN EUROPE-EU,POLAND,GLASGOW,POZNAN,0,0,0,1403,1403,0,-100
22/03/2018 09:29,201801,EASTERN EUROPE-EU,POLAND,GLASGOW,WARSAW (CHOPIN),0,0,0,3021,3021,0,-100
22/03/2018 09:29,201801,EASTERN EUROPE-EU,POLAND,GLASGOW,WARSAW (MODLIN MASOVIA),4339,4339,0,4614,4454,160,-5.960121
22/03/2018 09:29,201801,EASTERN EUROPE-EU,POLAND,GLASGOW,WROCLAW,3137,3137,0,3465,3465,0,-9.466089
22/03/2018 09:29,201801,EASTERN EUROPE-EU,POLAND,LEEDS BRADFORD,GDANSK,5295,5295,0,5379,5379,0,-1.561629
22/03/2018 09:29,201801,EASTERN EUROPE-EU,POLAND,LEEDS BRADFORD,KRAKOW,5690,5690,0,6127,6127,0,-7.132365
22/03/2018 09:29,201801,EASTERN EUROPE-EU,POLAND,LEEDS BRADFORD,WARSAW (MODLIN MASOVIA),3155,3155,0,3035,3035,0,3.953871
22/03/2018 09:29,201801,EASTERN EUROPE-EU,POLAND,LEEDS BRADFORD,WROCLAW,2758,2758,0,0,0,0,0
22/03/2018 09:29,201801,EASTERN EUROPE-EU,POLAND,LIVERPOOL (JOHN LENNON),GDANSK,4654,4654,0,4178,4178,0,11.393011
22/03/2018 09:29,201801,EASTERN EUROPE-EU,POLAND,LIVERPOOL (JOHN LENNON),KATOWICE,3402,3402,0,3165,3165,0,7.488152
22/03/2018 09:29,201801,EASTERN EUROPE-EU,POLAND,LIVERPOOL (JOHN LENNON),KRAKOW,8433,8433,0,8824,8824,0,-4.431097
22/03/2018 09:29,201801,EASTERN EUROPE-EU,POLAND,LIVERPOOL (JOHN LENNON),LUBLIN (PORT LOTNICZY),2274,2274,0,0,0,0,0
22/03/2018 09:29,201801,EASTERN EUROPE-EU,POLAND,LIVERPOOL (JOHN LENNON),POZNAN,3188,3188,0,4314,4314,0,-26.101066
22/03/2018 09:29,201801,EASTERN EUROPE-EU,POLAND,LIVERPOOL (JOHN LENNON),SZCZECIN (GOLENOW),2629,2629,0,3091,3091,0,-14.946619
22/03/2018 09:29,201801,EASTERN EUROPE-EU,POLAND,LIVERPOOL (JOHN LENNON),WARSAW (CHOPIN),3369,3369,0,3151,3151,0,6.918439
22/03/2018 09:29,201801,EASTERN EUROPE-EU,POLAND,LIVERPOOL (JOHN LENNON),WARSAW (MODLIN MASOVIA),6327,6327,0,6443,6443,0,-1.800404
22/03/2018 09:29,201801,EASTERN EUROPE-EU,POLAND,LIVERPOOL (JOHN LENNON),WROCLAW,4174,4174,0,4624,4624,0,-9.731834
22/03/2018 09:29,201801,EASTERN EUROPE-EU,POLAND,MANCHESTER,GDANSK,3536,3536,0,3178,3178,0,11.264947
22/03/2018 09:29,201801,EASTERN EUROPE-EU,POLAND,MANCHESTER,KRAKOW,11660,11660,0,11392,11392,0,2.352528
22/03/2018 09:29,201801,EASTERN EUROPE-EU,POLAND,MANCHESTER,RZESZOW,3588,3588,0,3407,3407,0,5.312592
22/03/2018 09:29,201801,EASTERN EUROPE-EU,POLAND,MANCHESTER,WARSAW (MODLIN MASOVIA),4419,4419,0,4758,4758,0,-7.124842
22/03/2018 09:29,201801,EASTERN EUROPE-EU,POLAND,MANCHESTER,WROCLAW,3011,3011,0,4367,4367,0,-31.051065
22/03/2018 09:29,201801,EASTERN EUROPE-EU,POLAND,NEWCASTLE,GDANSK,0,0,0,2565,2565,0,-100
22/03/2018 09:29,201801,EASTERN EUROPE-EU,POLAND,NEWCASTLE,KRAKOW,468,468,0,666,666,0,-29.72973
22/03/2018 09:29,201801,EASTERN EUROPE-EU,POLAND,NEWCASTLE,WARSAW (MODLIN MASOVIA),2660,2660,0,2630,2630,0,1.140684
22/03/2018 09:29,201801,EASTERN EUROPE-EU,POLAND,NEWCASTLE,WROCLAW,2232,2232,0,2639,2639,0,-15.422509
22/03/2018 09:29,201801,EASTERN EUROPE-EU,POLAND,PRESTWICK,RZESZOW,2576,2576,0,0,0,0,0
22/03/2018 09:29,201801,EASTERN EUROPE-EU,ROMANIA,GATWICK,BUCHAREST (OTOPENI),9497,9497,0,8419,8419,0,12.804371
22/03/2018 09:29,201801,EASTERN EUROPE-EU,ROMANIA,HEATHROW,BUCHAREST (OTOPENI),19329,19329,0,18469,18469,0,4.656451
22/03/2018 09:29,201801,EASTERN EUROPE-EU,ROMANIA,LUTON,BACAU,5788,5788,0,6461,6461,0,-10.416344
22/03/2018 09:29,201801,EASTERN EUROPE-EU,ROMANIA,LUTON,BUCHAREST (OTOPENI),44703,44703,0,43464,43464,0,2.850635
22/03/2018 09:29,201801,EASTERN EUROPE-EU,ROMANIA,LUTON,CLUJ NAPOCA,23474,23474,0,22488,22488,0,4.384561
22/03/2018 09:29,201801,EASTERN EUROPE-EU,ROMANIA,LUTON,CONSTANTA,3274,3274,0,2640,2640,0,24.015152
22/03/2018 09:29,201801,EASTERN EUROPE-EU,ROMANIA,LUTON,CRAIOVA,10255,10255,0,7496,7496,0,36.806297
22/03/2018 09:29,201801,EASTERN EUROPE-EU,ROMANIA,LUTON,IASI,15786,15786,0,11217,11217,0,40.732816
22/03/2018 09:29,201801,EASTERN EUROPE-EU,ROMANIA,LUTON,SATU MARE,2876,2876,0,2925,2925,0,-1.675214
22/03/2018 09:29,201801,EASTERN EUROPE-EU,ROMANIA,LUTON,SIBIU,6213,6213,0,5668,5668,0,9.615385
22/03/2018 09:29,201801,EASTERN EUROPE-EU,ROMANIA,LUTON,SUCEAVA,6902,6902,0,4422,4422,0,56.08322
22/03/2018 09:29,201801,EASTERN EUROPE-EU,ROMANIA,LUTON,TIMISOARA,9437,9437,0,9152,9152,0,3.114073
22/03/2018 09:29,201801,EASTERN EUROPE-EU,ROMANIA,STANSTED,BUCHAREST (OTOPENI),12439,12439,0,21442,21442,0,-41.987688
22/03/2018 09:29,201801,EASTERN EUROPE-EU,ROMANIA,STANSTED,ORADEA,4026,4026,0,0,0,0,0
22/03/2018 09:29,201801,EASTERN EUROPE-EU,ROMANIA,STANSTED,TIMISOARA,10133,10133,0,9957,9957,0,1.767601
22/03/2018 09:29,201801,EASTERN EUROPE-EU,ROMANIA,BIRMINGHAM,BUCHAREST (OTOPENI),7751,7751,0,3233,3233,0,139.746366
22/03/2018 09:29,201801,EASTERN EUROPE-EU,ROMANIA,BIRMINGHAM,CLUJ NAPOCA,2320,2320,0,0,0,0,0
22/03/2018 09:29,201801,EASTERN EUROPE-EU,ROMANIA,BRISTOL,BUCHAREST (OTOPENI),3533,3533,0,1647,1647,0,114.511233
22/03/2018 09:29,201801,EASTERN EUROPE-EU,ROMANIA,DONCASTER SHEFFIELD,BUCHAREST (OTOPENI),4495,4495,0,4442,4442,0,1.193156
22/03/2018 09:29,201801,EASTERN EUROPE-EU,ROMANIA,DONCASTER SHEFFIELD,CLUJ NAPOCA,2994,2994,0,2848,2848,0,5.126404
22/03/2018 09:29,201801,EASTERN EUROPE-EU,ROMANIA,GLASGOW,BUCHAREST (OTOPENI),2600,2600,0,4568,4568,0,-43.082312
22/03/2018 09:29,201801,EASTERN EUROPE-EU,ROMANIA,LIVERPOOL (JOHN LENNON),BACAU,2253,2253,0,1889,1889,0,19.269455
22/03/2018 09:29,201801,EASTERN EUROPE-EU,ROMANIA,LIVERPOOL (JOHN LENNON),BUCHAREST (OTOPENI),5383,5383,0,5292,5292,0,1.719577
22/03/2018 09:29,201801,EASTERN EUROPE-EU,ROMANIA,LIVERPOOL (JOHN LENNON),CLUJ NAPOCA,2045,2045,0,2048,2048,0,-0.146484
22/03/2018 09:29,201801,EASTERN EUROPE-EU,ROMANIA,LIVERPOOL (JOHN LENNON),IASI,162,162,0,0,0,0,0
22/03/2018 09:29,201801,EASTERN EUROPE-EU,ROMANIA,MANCHESTER,BUCHAREST (OTOPENI),373,186,187,0,0,0,0
22/03/2018 09:29,201801,EASTERN EUROPE-EU,SLOVAK REPUBLIC,GATWICK,BRATISLAVA,7,0,7,0,0,0,0
22/03/2018 09:29,201801,EASTERN EUROPE-EU,SLOVAK REPUBLIC,LUTON,KOSICE,10448,10448,0,10280,10280,0,1.634241
22/03/2018 09:29,201801,EASTERN EUROPE-EU,SLOVAK REPUBLIC,LUTON,TATRY-POPRAD,4357,4357,0,4388,4388,0,-0.706472
22/03/2018 09:29,201801,EASTERN EUROPE-EU,SLOVAK REPUBLIC,STANSTED,BRATISLAVA,17440,17440,0,15566,15566,0,12.039059
22/03/2018 09:29,201801,EASTERN EUROPE-EU,SLOVAK REPUBLIC,BIRMINGHAM,BRATISLAVA,4284,4284,0,4765,4765,0,-10.094439
22/03/2018 09:29,201801,EASTERN EUROPE-EU,SLOVAK REPUBLIC,BRISTOL,KOSICE,0,0,0,1606,1606,0,-100
22/03/2018 09:29,201801,EASTERN EUROPE-EU,SLOVAK REPUBLIC,DONCASTER SHEFFIELD,KOSICE,3539,3539,0,3577,3577,0,-1.062343
22/03/2018 09:29,201801,EASTERN EUROPE-EU,SLOVAK REPUBLIC,EDINBURGH,BRATISLAVA,2496,2496,0,2892,2892,0,-13.692946
22/03/2018 09:29,201801,EASTERN EUROPE-EU,SLOVAK REPUBLIC,LEEDS BRADFORD,BRATISLAVA,2790,2790,0,2778,2778,0,0.431965
22/03/2018 09:29,201801,EASTERN EUROPE-EU,SLOVAK REPUBLIC,MANCHESTER,BRATISLAVA,4809,4809,0,5180,5180,0,-7.162162
22/03/2018 09:29,201801,EASTERN EUROPE -OTHER,ALBANIA,GATWICK,TIRANA,9267,9047,220,7051,6194,857,31.428166
22/03/2018 09:29,201801,EASTERN EUROPE -OTHER,ALBANIA,STANSTED,TIRANA,452,0,452,0,0,0,0
22/03/2018 09:29,201801,EASTERN EUROPE -OTHER,AZERBAIJAN,HEATHROW,BAKU (HEYDER ALIYEV INT'L),3521,3521,0,4404,4404,0,-20.049955
22/03/2018 09:29,201801,EASTERN EUROPE -OTHER,BELARUS,GATWICK,MINSK INT'L ,1995,1995,0,1753,1753,0,13.804906
22/03/2018 09:29,201801,EASTERN EUROPE -OTHER,GEORGIA,GATWICK,TBILISI,656,656,0,0,0,0,0
22/03/2018 09:29,201801,EASTERN EUROPE -OTHER,GEORGIA,LUTON,KUTAISI,1803,1803,0,0,0,0,0
22/03/2018 09:29,201801,EASTERN EUROPE -OTHER,KAZAKHSTAN,HEATHROW,ASTANA,3081,3081,0,3016,3016,0,2.155172
22/03/2018 09:29,201801,EASTERN EUROPE -OTHER,REPUBLIC OF MOLDOVA,LUTON,CHISINAU (KISHINEV),7583,7583,0,5639,5639,0,34.474198
22/03/2018 09:29,201801,EASTERN EUROPE -OTHER,REPUBLIC OF MOLDOVA,STANSTED,CHISINAU (KISHINEV),4501,4501,0,4685,4685,0,-3.927428
22/03/2018 09:29,201801,EASTERN EUROPE -OTHER,RUSSIA,GATWICK,MOSCOW (SHEREMETYEVO),6467,6467,0,6219,6219,0,3.987779
22/03/2018 09:29,201801,EASTERN EUROPE -OTHER,RUSSIA,HEATHROW,MOSCOW (DOMODEDOVO),16829,16829,0,18543,18543,0,-9.24338
22/03/2018 09:29,201801,EASTERN EUROPE -OTHER,RUSSIA,HEATHROW,MOSCOW (SHEREMETYEVO),27965,27965,0,28772,28772,0,-2.80481
22/03/2018 09:29,201801,EASTERN EUROPE -OTHER,RUSSIA,HEATHROW,ST PETERSBURG,6673,6673,0,5906,5906,0,12.986793
22/03/2018 09:29,201801,EASTERN EUROPE -OTHER,RUSSIA,LUTON,MOSCOW (VNUKOVO),0,0,0,2,0,2,-100
22/03/2018 09:29,201801,EASTERN EUROPE -OTHER,TURKMENISTAN,HEATHROW,ASHKHABAD,551,551,0,882,882,0,-37.528345
22/03/2018 09:29,201801,EASTERN EUROPE -OTHER,TURKMENISTAN,BIRMINGHAM,ASHKHABAD,6357,6357,0,2733,2733,0,132.601537
22/03/2018 09:29,201801,EASTERN EUROPE -OTHER,UKRAINE,GATWICK,KIEV (BORISPOL),11922,11922,0,13540,13540,0,-11.949778
22/03/2018 09:29,201801,EASTERN EUROPE -OTHER,UKRAINE,HEATHROW,KIEV (BORISPOL),6124,6124,0,4970,4970,0,23.219316
22/03/2018 09:29,201801,EASTERN EUROPE -OTHER,UKRAINE,LUTON,KIEV (ZHULYANY),4809,4809,0,2787,2787,0,72.55113
22/03/2018 09:29,201801,EASTERN EUROPE -OTHER,UZBEKISTAN,HEATHROW,TASHKENT,2251,2251,0,2014,2014,0,11.767627
22/03/2018 09:29,201801,NEAR EAST,ISRAEL,GATWICK,TEL AVIV,2928,2928,0,3346,3346,0,-12.492528
22/03/2018 09:29,201801,NEAR EAST,ISRAEL,HEATHROW,TEL AVIV,43346,43346,0,44506,44506,0,-2.60639
22/03/2018 09:29,201801,NEAR EAST,ISRAEL,LUTON,OVDA,0,0,0,533,533,0,-100
22/03/2018 09:29,201801,NEAR EAST,ISRAEL,LUTON,TEL AVIV,29734,29734,0,21190,20596,594,40.320906
22/03/2018 09:29,201801,NEAR EAST,ISRAEL,MANCHESTER,TEL AVIV,3213,3213,0,5363,5363,0,-40.089502
22/03/2018 09:29,201801,NEAR EAST,JORDAN,HEATHROW,AMMAN,16114,16114,0,17040,17040,0,-5.434272
22/03/2018 09:29,201801,NEAR EAST,LEBANON,HEATHROW,BEIRUT,20957,20957,0,21319,21319,0,-1.698016
22/03/2018 09:29,201801,NORTH AFRICA,ALGERIA,GATWICK,ALGIERS,4202,4202,0,3530,3530,0,19.036827
22/03/2018 09:29,201801,NORTH AFRICA,ALGERIA,HEATHROW,ALGIERS,5787,5787,0,6017,6017,0,-3.822503
22/03/2018 09:29,201801,NORTH AFRICA,EGYPT,GATWICK,HURGHADA,13881,13881,0,10743,5291,5452,29.209718
22/03/2018 09:29,201801,NORTH AFRICA,EGYPT,GATWICK,MARSA ALAM,2321,2321,0,896,896,0,159.040179
22/03/2018 09:29,201801,NORTH AFRICA,EGYPT,HEATHROW,CAIRO,29757,29757,0,30395,30395,0,-2.099029
22/03/2018 09:29,201801,NORTH AFRICA,EGYPT,HEATHROW,LUXOR,1050,1050,0,819,819,0,28.205128
22/03/2018 09:29,201801,NORTH AFRICA,EGYPT,STANSTED,HURGHADA,0,0,0,135,0,135,-100
22/03/2018 09:29,201801,NORTH AFRICA,EGYPT,BIRMINGHAM,HURGHADA,5525,5525,0,2125,0,2125,160
22/03/2018 09:29,201801,NORTH AFRICA,EGYPT,BIRMINGHAM,MARSA ALAM,1905,1905,0,0,0,0,0
22/03/2018 09:29,201801,NORTH AFRICA,EGYPT,GLASGOW,HURGHADA,453,453,0,0,0,0,0
22/03/2018 09:29,201801,NORTH AFRICA,EGYPT,MANCHESTER,HURGHADA,9604,9604,0,8011,0,8011,19.885158
22/03/2018 09:29,201801,NORTH AFRICA,EGYPT,NEWCASTLE,HURGHADA,1932,1932,0,0,0,0,0
22/03/2018 09:29,201801,NORTH AFRICA,MOROCCO,GATWICK,AGADIR (AL MASSIRA),7453,7453,0,7563,7563,0,-1.454449
22/03/2018 09:29,201801,NORTH AFRICA,MOROCCO,GATWICK,CASABLANCA MOHAMED V,5419,5419,0,3157,3157,0,71.650301
22/03/2018 09:29,201801,NORTH AFRICA,MOROCCO,GATWICK,FEZ,949,949,0,0,0,0,0
22/03/2018 09:29,201801,NORTH AFRICA,MOROCCO,GATWICK,MARRAKESH,24425,24425,0,21541,21541,0,13.388422
22/03/2018 09:29,201801,NORTH AFRICA,MOROCCO,GATWICK,RABAT,0,0,0,1109,1109,0,-100
22/03/2018 09:29,201801,NORTH AFRICA,MOROCCO,GATWICK,TANGIERS (IBN BATUTA),1885,1885,0,1905,1905,0,-1.049869
22/03/2018 09:29,201801,NORTH AFRICA,MOROCCO,HEATHROW,CASABLANCA MOHAMED V,6801,6801,0,7450,7450,0,-8.711409
22/03/2018 09:29,201801,NORTH AFRICA,MOROCCO,HEATHROW,RABAT,991,991,0,0,0,0,0
22/03/2018 09:29,201801,NORTH AFRICA,MOROCCO,LUTON,ESSAOUIRA,2422,2422,0,2248,2248,0,7.740214
22/03/2018 09:29,201801,NORTH AFRICA,MOROCCO,LUTON,MARRAKESH,3261,3261,0,3240,3240,0,0.648148
22/03/2018 09:29,201801,NORTH AFRICA,MOROCCO,STANSTED,AGADIR (AL MASSIRA),3310,3310,0,3039,3039,0,8.917407
22/03/2018 09:29,201801,NORTH AFRICA,MOROCCO,STANSTED,FEZ,3026,3026,0,3039,3039,0,-0.427772
22/03/2018 09:29,201801,NORTH AFRICA,MOROCCO,STANSTED,MARRAKESH,10535,10535,0,10513,10513,0,0.209265
22/03/2018 09:29,201801,NORTH AFRICA,MOROCCO,STANSTED,RABAT,4428,4428,0,4446,4446,0,-0.404858
22/03/2018 09:29,201801,NORTH AFRICA,MOROCCO,BIRMINGHAM,MARRAKESH,1341,1341,0,1440,1440,0,-6.875
22/03/2018 09:29,201801,NORTH AFRICA,MOROCCO,BRISTOL,MARRAKESH,0,0,0,2558,2558,0,-100
22/03/2018 09:29,201801,NORTH AFRICA,MOROCCO,LIVERPOOL (JOHN LENNON),MARRAKESH,2937,2937,0,2832,2832,0,3.707627
22/03/2018 09:29,201801,NORTH AFRICA,MOROCCO,MANCHESTER,AGADIR (AL MASSIRA),7239,7239,0,3244,3244,0,123.150432
22/03/2018 09:29,201801,NORTH AFRICA,MOROCCO,MANCHESTER,CASABLANCA MOHAMED V,1739,1739,0,0,0,0,0
22/03/2018 09:29,201801,NORTH AFRICA,MOROCCO,MANCHESTER,MARRAKESH,6804,6804,0,6440,6440,0,5.652174
22/03/2018 09:29,201801,NORTH AFRICA,TUNISIA,GATWICK,TUNIS,2708,2708,0,1779,1779,0,52.220349
22/03/2018 09:29,201801,NORTH AFRICA,TUNISIA,HEATHROW,TUNIS,3290,3290,0,3677,3677,0,-10.524884
22/03/2018 09:29,201801,NORTH AFRICA,TUNISIA,STANSTED,TUNIS,0,0,0,29,0,29,-100
22/03/2018 09:29,201801,EAST AFRICA,ETHIOPIA,HEATHROW,ADDIS ABABA,17636,17636,0,16162,16162,0,9.120158
22/03/2018 09:29,201801,EAST AFRICA,KENYA,HEATHROW,NAIROBI,31255,31255,0,24453,24453,0,27.816628
22/03/2018 09:29,201801,EAST AFRICA,RWANDA,GATWICK,KIGALI,2584,2584,0,0,0,0,0
22/03/2018 09:29,201801,WEST AFRICA,GAMBIA,GATWICK,BANJUL,10135,7431,2704,6473,3819,2654,56.573459
22/03/2018 09:29,201801,WEST AFRICA,GAMBIA,BIRMINGHAM,BANJUL,3702,3702,0,2168,2162,6,70.756458
22/03/2018 09:29,201801,WEST AFRICA,GAMBIA,MANCHESTER,BANJUL,5569,5569,0,3655,3438,217,52.366621
22/03/2018 09:29,201801,WEST AFRICA,GHANA,HEATHROW,ACCRA,16855,16855,0,17091,17091,0,-1.380844
22/03/2018 09:29,201801,WEST AFRICA,NIGERIA,GATWICK,LAGOS,5174,5174,0,8624,8624,0,-40.004638
22/03/2018 09:29,201801,WEST AFRICA,NIGERIA,HEATHROW,ABUJA,10547,10547,0,10251,10251,0,2.887523
22/03/2018 09:29,201801,WEST AFRICA,NIGERIA,HEATHROW,LAGOS,30628,30628,0,30659,30659,0,-0.101112
22/03/2018 09:29,201801,WEST AFRICA,NIGERIA,LUTON,ABUJA,0,0,0,3,0,3,-100
22/03/2018 09:29,201801,CENTRAL AFRICA,ANGOLA,HEATHROW,LUANDA,609,609,0,1297,1297,0,-53.04549
22/03/2018 09:29,201801,SOUTHERN AFRICA,REPUBLIC OF SOUTH AFRICA,GATWICK,CAPE TOWN,14471,13547,924,12300,12300,0,17.650407
22/03/2018 09:29,201801,SOUTHERN AFRICA,REPUBLIC OF SOUTH AFRICA,HEATHROW,CAPE TOWN,40646,40646,0,41773,41773,0,-2.697915
22/03/2018 09:29,201801,SOUTHERN AFRICA,REPUBLIC OF SOUTH AFRICA,HEATHROW,JOHANNESBURG,83519,83519,0,80512,80512,0,3.734847
22/03/2018 09:29,201801,SOUTHERN AFRICA,REPUBLIC OF SOUTH AFRICA,MANCHESTER,CAPE TOWN,701,0,701,0,0,0,0
22/03/2018 09:29,201801,MIDDLE EAST,BAHRAIN,HEATHROW,BAHRAIN,27901,27901,0,27411,27411,0,1.787604
22/03/2018 09:29,201801,MIDDLE EAST,IRAN,HEATHROW,TEHRAN IMAM KHOMEINI,8849,8849,0,10604,10604,0,-16.550358
22/03/2018 09:29,201801,MIDDLE EAST,IRAQ,GATWICK,BAGHDAD (GECA),1247,1247,0,786,786,0,58.651399
22/03/2018 09:29,201801,MIDDLE EAST,IRAQ,GATWICK,SULAYMANIYAH INT,0,0,0,694,694,0,-100
22/03/2018 09:29,201801,MIDDLE EAST,IRAQ,MANCHESTER,BAGHDAD (GECA),779,779,0,1144,1144,0,-31.905594
22/03/2018 09:29,201801,MIDDLE EAST,KUWAIT,HEATHROW,KUWAIT,34978,34978,0,33236,33236,0,5.241305
22/03/2018 09:29,201801,MIDDLE EAST,OMAN,HEATHROW,MUSCAT,31609,31609,0,29588,29588,0,6.830472
22/03/2018 09:29,201801,MIDDLE EAST,OMAN,MANCHESTER,MUSCAT,9057,9057,0,0,0,0,0
22/03/2018 09:29,201801,MIDDLE EAST,QATAR,HEATHROW,DOHA HAMAD,112501,112501,0,117865,117865,0,-4.550969
22/03/2018 09:29,201801,MIDDLE EAST,QATAR,BIRMINGHAM,DOHA HAMAD,10883,10883,0,11440,11440,0,-4.868881
22/03/2018 09:29,201801,MIDDLE EAST,QATAR,EDINBURGH,DOHA HAMAD,11613,11613,0,11522,11522,0,0.789793
22/03/2018 09:29,201801,MIDDLE EAST,QATAR,MANCHESTER,DOHA HAMAD,27765,27765,0,30760,30760,0,-9.736671
22/03/2018 09:29,201801,MIDDLE EAST,SAUDI ARABIA,HEATHROW,JEDDAH,21169,21169,0,18293,18293,0,15.721861
22/03/2018 09:29,201801,MIDDLE EAST,SAUDI ARABIA,HEATHROW,RIYADH,23571,23571,0,19898,19898,0,18.459142
22/03/2018 09:29,201801,MIDDLE EAST,SAUDI ARABIA,MANCHESTER,JEDDAH,9142,9142,0,8538,8538,0,7.074256
22/03/2018 09:29,201801,MIDDLE EAST,UNITED ARAB EMIRATES,GATWICK,DUBAI,86631,86631,0,83912,83912,0,3.240299
22/03/2018 09:29,201801,MIDDLE EAST,UNITED ARAB EMIRATES,GATWICK,DUBAI (WORLD CENTRAL),0,0,0,3094,0,3094,-100
22/03/2018 09:29,201801,MIDDLE EAST,UNITED ARAB EMIRATES,HEATHROW,ABU DHABI INTERNATIONAL,84186,84186,0,89092,89092,0,-5.506667
22/03/2018 09:29,201801,MIDDLE EAST,UNITED ARAB EMIRATES,HEATHROW,DUBAI,233442,233442,0,235557,235557,0,-0.897872
22/03/2018 09:29,201801,MIDDLE EAST,UNITED ARAB EMIRATES,BIRMINGHAM,DUBAI,62241,62241,0,68307,68307,0,-8.880495
22/03/2018 09:29,201801,MIDDLE EAST,UNITED ARAB EMIRATES,BIRMINGHAM,DUBAI (WORLD CENTRAL),0,0,0,2809,0,2809,-100
22/03/2018 09:29,201801,MIDDLE EAST,UNITED ARAB EMIRATES,CARDIFF WALES,DUBAI (WORLD CENTRAL),0,0,0,558,0,558,-100
22/03/2018 09:29,201801,MIDDLE EAST,UNITED ARAB EMIRATES,EDINBURGH,ABU DHABI INTERNATIONAL,9540,9540,0,10479,10479,0,-8.960779
22/03/2018 09:29,201801,MIDDLE EAST,UNITED ARAB EMIRATES,GLASGOW,DUBAI,40154,40154,0,41106,41106,0,-2.315964
22/03/2018 09:29,201801,MIDDLE EAST,UNITED ARAB EMIRATES,GLASGOW,DUBAI (WORLD CENTRAL),0,0,0,293,0,293,-100
22/03/2018 09:29,201801,MIDDLE EAST,UNITED ARAB EMIRATES,LIVERPOOL (JOHN LENNON),DUBAI (WORLD CENTRAL),59,0,59,0,0,0,0
22/03/2018 09:29,201801,MIDDLE EAST,UNITED ARAB EMIRATES,MANCHESTER,ABU DHABI INTERNATIONAL,39108,39108,0,36574,36574,0,6.928419
22/03/2018 09:29,201801,MIDDLE EAST,UNITED ARAB EMIRATES,MANCHESTER,DUBAI,88650,88650,0,90003,90003,0,-1.503283
22/03/2018 09:29,201801,MIDDLE EAST,UNITED ARAB EMIRATES,MANCHESTER,DUBAI (WORLD CENTRAL),105,0,105,3172,0,3172,-96.689786
22/03/2018 09:29,201801,MIDDLE EAST,UNITED ARAB EMIRATES,NEWCASTLE,DUBAI,21524,21186,338,21109,21109,0,1.965986
22/03/2018 09:29,201801,MIDDLE EAST,UNITED ARAB EMIRATES,NEWCASTLE,DUBAI (WORLD CENTRAL),0,0,0,577,286,291,-100
22/03/2018 09:29,201801,INDIAN SUB-CONTINENT,BANGLADESH,HEATHROW,DHAKHA,7076,7076,0,7067,7067,0,0.127352
22/03/2018 09:29,201801,INDIAN SUB-CONTINENT,BANGLADESH,HEATHROW,SYLHET,5851,5851,0,5819,5819,0,0.549923
22/03/2018 09:29,201801,INDIAN SUB-CONTINENT,INDIA,GATWICK,GOA,9914,7630,2284,10442,7759,2683,-5.056503
22/03/2018 09:29,201801,INDIAN SUB-CONTINENT,INDIA,HEATHROW,AHMEDABAD,5515,5515,0,6420,6420,0,-14.096573
22/03/2018 09:29,201801,INDIAN SUB-CONTINENT,INDIA,HEATHROW,AMRITSAR,406,406,0,251,251,0,61.752988
22/03/2018 09:29,201801,INDIAN SUB-CONTINENT,INDIA,HEATHROW,BANGALORE (BENGALURU),14860,14860,0,14164,14164,0,4.913866
22/03/2018 09:29,201801,INDIAN SUB-CONTINENT,INDIA,HEATHROW,CHENNAI,11972,11972,0,12524,12524,0,-4.407538
22/03/2018 09:29,201801,INDIAN SUB-CONTINENT,INDIA,HEATHROW,DELHI,91528,91528,0,87924,87924,0,4.098995
22/03/2018 09:29,201801,INDIAN SUB-CONTINENT,INDIA,HEATHROW,HYDERABAD ( RAJIV GHANDI ),11867,11867,0,11970,11970,0,-0.860485
22/03/2018 09:29,201801,INDIAN SUB-CONTINENT,INDIA,HEATHROW,MUMBAI,105239,105239,0,87501,87501,0,20.271768
22/03/2018 09:29,201801,INDIAN SUB-CONTINENT,INDIA,BIRMINGHAM,AMRITSAR,6772,6772,0,6794,6794,0,-0.323815
22/03/2018 09:29,201801,INDIAN SUB-CONTINENT,INDIA,BIRMINGHAM,DELHI,6703,6703,0,7223,7223,0,-7.199225
22/03/2018 09:29,201801,INDIAN SUB-CONTINENT,INDIA,BIRMINGHAM,GOA,1156,0,1156,0,0,0,0
22/03/2018 09:29,201801,INDIAN SUB-CONTINENT,INDIA,MANCHESTER,GOA,13793,10390,3403,10099,7792,2307,36.577879
22/03/2018 09:29,201801,INDIAN SUB-CONTINENT,PAKISTAN,GATWICK,ISLAMABAD,75,0,75,140,0,140,-46.428571
22/03/2018 09:29,201801,INDIAN SUB-CONTINENT,PAKISTAN,HEATHROW,ISLAMABAD,13128,13128,0,7507,7507,0,74.876782
22/03/2018 09:29,201801,INDIAN SUB-CONTINENT,PAKISTAN,HEATHROW,KARACHI,4696,4696,0,4660,4660,0,0.772532
22/03/2018 09:29,201801,INDIAN SUB-CONTINENT,PAKISTAN,HEATHROW,LAHORE,8716,8716,0,5832,5832,0,49.451303
22/03/2018 09:29,201801,INDIAN SUB-CONTINENT,PAKISTAN,BIRMINGHAM,ISLAMABAD,6759,6759,0,6886,6886,0,-1.844322
22/03/2018 09:29,201801,INDIAN SUB-CONTINENT,PAKISTAN,MANCHESTER,ISLAMABAD,17686,17686,0,20326,20326,0,-12.988291
22/03/2018 09:29,201801,INDIAN SUB-CONTINENT,PAKISTAN,MANCHESTER,KARACHI,0,0,0,14,14,0,-100
22/03/2018 09:29,201801,INDIAN SUB-CONTINENT,PAKISTAN,MANCHESTER,LAHORE,4810,4810,0,4144,4144,0,16.071429
22/03/2018 09:29,201801,INDIAN SUB-CONTINENT,SRI LANKA,GATWICK,COLOMBO,1184,0,1184,2419,0,2419,-51.054155
22/03/2018 09:29,201801,INDIAN SUB-CONTINENT,SRI LANKA,HEATHROW,COLOMBO,23386,23386,0,21124,21124,0,10.708199
22/03/2018 09:29,201801,FAR EAST,BRUNEI,HEATHROW,BANDAR SERI BEGAWAN,5589,5589,0,5825,5825,0,-4.051502
22/03/2018 09:29,201801,FAR EAST,CHINA,GATWICK,CHONGQING JIANGBEI INTERNATIONAL,1431,1431,0,0,0,0,0
22/03/2018 09:29,201801,FAR EAST,CHINA,GATWICK,TIANJIN,1741,1741,0,3558,3558,0,-51.068016
22/03/2018 09:29,201801,FAR EAST,CHINA,GATWICK,XIAMEN,0,0,0,8,0,8,-100
22/03/2018 09:29,201801,FAR EAST,CHINA,HEATHROW,BEIJING,37788,37788,0,39810,39810,0,-5.079126
22/03/2018 09:29,201801,FAR EAST,CHINA,HEATHROW,CHENGDU,0,0,0,1562,1562,0,-100
22/03/2018 09:29,201801,FAR EAST,CHINA,HEATHROW,GUANGZHOU BAIYUN INTERNATIONAL,17108,17108,0,11759,11759,0,45.488562
22/03/2018 09:29,201801,FAR EAST,CHINA,HEATHROW,SHANGHAI (PU DONG),40434,40434,0,41689,41689,0,-3.010386
22/03/2018 09:29,201801,FAR EAST,CHINA,MANCHESTER,BEIJING,5414,5414,0,8051,8051,0,-32.753695
22/03/2018 09:29,201801,FAR EAST,HONG KONG,GATWICK,HONG KONG (CHEK LAP KOK),13724,13724,0,9637,9637,0,42.409464
22/03/2018 09:29,201801,FAR EAST,HONG KONG,HEATHROW,HONG KONG (CHEK LAP KOK),130819,130819,0,140285,140285,0,-6.747692
22/03/2018 09:29,201801,FAR EAST,HONG KONG,MANCHESTER,HONG KONG (CHEK LAP KOK),15599,15599,0,11860,11860,0,31.526138
22/03/2018 09:29,201801,FAR EAST,INDONESIA,HEATHROW,JAKARTA (SOEKARNO-HATTA INTNL),4968,4968,0,3075,3075,0,61.560976
22/03/2018 09:29,201801,FAR EAST,JAPAN,HEATHROW,TOKYO (HANEDA),42183,42183,0,35729,35729,0,18.063758
22/03/2018 09:29,201801,FAR EAST,JAPAN,HEATHROW,TOKYO (NARITA),7982,7982,0,10722,10722,0,-25.554934
22/03/2018 09:29,201801,FAR EAST,MALAYSIA,HEATHROW,KUALA LUMPUR (SEPANG),49918,49918,0,62669,62669,0,-20.346583
22/03/2018 09:29,201801,FAR EAST,PHILIPPINES,HEATHROW,MANILA,14841,14841,0,11194,11194,0,32.579954
22/03/2018 09:29,201801,FAR EAST,REPUBLIC OF KOREA,HEATHROW,SEOUL (INCHEON),42501,42501,0,39855,39855,0,6.639067
22/03/2018 09:29,201801,FAR EAST,SINGAPORE,GATWICK,SINGAPORE,11079,11079,0,0,0,0,0
22/03/2018 09:29,201801,FAR EAST,SINGAPORE,HEATHROW,SINGAPORE,99531,99531,0,100569,100569,0,-1.032127
22/03/2018 09:29,201801,FAR EAST,SINGAPORE,MANCHESTER,SINGAPORE,7187,7187,0,6702,6702,0,7.236646
22/03/2018 09:29,201801,FAR EAST,TAIWAN,GATWICK,TAIPEI,8356,8356,0,0,0,0,0
22/03/2018 09:29,201801,FAR EAST,TAIWAN,HEATHROW,TAIPEI,1761,1761,0,1955,1955,0,-9.923274
22/03/2018 09:29,201801,FAR EAST,THAILAND,GATWICK,KRABI,1747,0,1747,0,0,0,0
22/03/2018 09:29,201801,FAR EAST,THAILAND,GATWICK,PHUKET,2364,0,2364,2330,0,2330,1.459227
22/03/2018 09:29,201801,FAR EAST,THAILAND,HEATHROW,BANGKOK SUVARNABHUMI ,72874,72874,0,75938,75938,0,-4.034871
22/03/2018 09:29,201801,FAR EAST,THAILAND,BIRMINGHAM,PHUKET,1374,0,1374,0,0,0,0
22/03/2018 09:29,201801,FAR EAST,THAILAND,MANCHESTER,PHUKET,1146,0,1146,1128,0,1128,1.595745
22/03/2018 09:29,201801,FAR EAST,VIETNAM,GATWICK,PHU QUOC INTERNATIONAL,2479,0,2479,0,0,0,0
22/03/2018 09:29,201801,FAR EAST,VIETNAM,HEATHROW,HANOI,7291,7291,0,8078,8078,0,-9.742511
22/03/2018 09:29,201801,FAR EAST,VIETNAM,HEATHROW,HO CHI MINH CITY,6246,6246,0,6158,6158,0,1.429035
22/03/2018 09:29,201801,AUSTRALASIA,AUSTRALIA,HEATHROW,MELBOURNE,15040,15040,0,14348,14348,0,4.822972
22/03/2018 09:29,201801,AUSTRALASIA,AUSTRALIA,HEATHROW,SYDNEY,20407,20407,0,27779,27779,0,-26.538032
22/03/2018 09:29,201801,AUSTRALASIA,NEW ZEALAND,HEATHROW,AUCKLAND INTERNATIONAL,1581,1581,0,1800,1800,0,-12.166667
22/03/2018 09:29,201801,CANADA,CANADA,GATWICK,CALGARY,6967,6967,0,6460,6460,0,7.848297
22/03/2018 09:29,201801,CANADA,CANADA,GATWICK,ST JOHNS,336,336,0,0,0,0,0
22/03/2018 09:29,201801,CANADA,CANADA,GATWICK,TORONTO,26022,26022,0,24371,24371,0,6.774445
22/03/2018 09:29,201801,CANADA,CANADA,GATWICK,VANCOUVER,1179,1179,0,4010,4010,0,-70.598504
22/03/2018 09:29,201801,CANADA,CANADA,HEATHROW,CALGARY,26193,26193,0,20969,20969,0,24.912967
22/03/2018 09:29,201801,CANADA,CANADA,HEATHROW,HALIFAX INT,3181,3181,0,4459,4459,0,-28.661135
22/03/2018 09:29,201801,CANADA,CANADA,HEATHROW,MONTREAL (DORVAL),23958,23958,0,22630,22630,0,5.868316
22/03/2018 09:29,201801,CANADA,CANADA,HEATHROW,OTTAWA INTERNATIONAL,8765,8765,0,8300,8300,0,5.60241
22/03/2018 09:29,201801,CANADA,CANADA,HEATHROW,ST JOHNS,2000,2000,0,1719,1719,0,16.346713
22/03/2018 09:29,201801,CANADA,CANADA,HEATHROW,TORONTO,81187,81187,0,76553,76553,0,6.053323
22/03/2018 09:29,201801,CANADA,CANADA,HEATHROW,VANCOUVER,37653,37653,0,36694,36694,0,2.613506
22/03/2018 09:29,201801,CANADA,CANADA,GLASGOW,TORONTO,2768,2768,0,1687,1687,0,64.078245
22/03/2018 09:29,201801,CANADA,CANADA,MANCHESTER,TORONTO,3793,3793,0,2297,2297,0,65.128428
22/03/2018 09:29,201801,UNITED STATES OF AMERICA,USA,GATWICK,BOSTON,13703,13703,0,10429,10429,0,31.39323
22/03/2018 09:29,201801,UNITED STATES OF AMERICA,USA,GATWICK,DENVER INTERNATIONAL,5870,5870,0,0,0,0,0
22/03/2018 09:29,201801,UNITED STATES OF AMERICA,USA,GATWICK,FORT LAUDERDALE,15673,15673,0,8138,8138,0,92.590317
22/03/2018 09:29,201801,UNITED STATES OF AMERICA,USA,GATWICK,LAS VEGAS,17251,17251,0,16152,16152,0,6.804111
22/03/2018 09:29,201801,UNITED STATES OF AMERICA,USA,GATWICK,LOS ANGELES INTERNATIONAL,19017,19017,0,13720,13720,0,38.607872
22/03/2018 09:29,201801,UNITED STATES OF AMERICA,USA,GATWICK,NEW YORK (JF KENNEDY),44975,44975,0,29726,29726,0,51.298527
22/03/2018 09:29,201801,UNITED STATES OF AMERICA,USA,GATWICK,NEWBURGH/USA,344,344,0,0,0,0,0
22/03/2018 09:29,201801,UNITED STATES OF AMERICA,USA,GATWICK,OAKLAND,12923,12923,0,7316,7316,0,76.640241
22/03/2018 09:29,201801,UNITED STATES OF AMERICA,USA,GATWICK,ORLANDO,41309,41309,0,38549,38549,0,7.159719
22/03/2018 09:29,201801,UNITED STATES OF AMERICA,USA,GATWICK,SEATTLE (TACOMA),7342,7342,0,0,0,0,0
22/03/2018 09:29,201801,UNITED STATES OF AMERICA,USA,GATWICK,TAMPA,9160,9160,0,9301,9301,0,-1.515966
22/03/2018 09:29,201801,UNITED STATES OF AMERICA,USA,HEATHROW,ATLANTA,42718,42718,0,41742,41742,0,2.338173
22/03/2018 09:29,201801,UNITED STATES OF AMERICA,USA,HEATHROW,AUSTIN (BERGSTROM),10605,10605,0,9882,9882,0,7.316333
22/03/2018 09:29,201801,UNITED STATES OF AMERICA,USA,HEATHROW,BALTIMORE,9548,9548,0,8876,8876,0,7.570978
22/03/2018 09:29,201801,UNITED STATES OF AMERICA,USA,HEATHROW,BOSTON,52692,52692,0,55072,55072,0,-4.321615
22/03/2018 09:29,201801,UNITED STATES OF AMERICA,USA,HEATHROW,CHARLOTTE,19985,19985,0,21247,21247,0,-5.939662
22/03/2018 09:29,201801,UNITED STATES OF AMERICA,USA,HEATHROW,CHICAGO (O'HARE),71563,71563,0,71600,71600,0,-0.051676
22/03/2018 09:29,201801,UNITED STATES OF AMERICA,USA,HEATHROW,DALLAS/FORT WORTH,46608,46608,0,50288,50288,0,-7.317849
22/03/2018 09:29,201801,UNITED STATES OF AMERICA,USA,HEATHROW,DENVER INTERNATIONAL,14515,14515,0,14949,14757,192,-2.903204
22/03/2018 09:29,201801,UNITED STATES OF AMERICA,USA,HEATHROW,DETROIT,13417,13417,0,14391,14391,0,-6.768119
22/03/2018 09:29,201801,UNITED STATES OF AMERICA,USA,HEATHROW,HOUSTON,35857,35857,0,36878,36878,0,-2.768588
22/03/2018 09:29,201801,UNITED STATES OF AMERICA,USA,HEATHROW,INDIANAPOLIS,0,0,0,243,243,0,-100
22/03/2018 09:29,201801,UNITED STATES OF AMERICA,USA,HEATHROW,LAS VEGAS,27182,27182,0,26660,26660,0,1.957989
22/03/2018 09:29,201801,UNITED STATES OF AMERICA,USA,HEATHROW,LOS ANGELES INTERNATIONAL,110846,110846,0,110716,110716,0,0.117418
22/03/2018 09:29,201801,UNITED STATES OF AMERICA,USA,HEATHROW,MIAMI INTERNATIONAL,89551,89551,0,86588,86588,0,3.421952
22/03/2018 09:29,201801,UNITED STATES OF AMERICA,USA,HEATHROW,MINNEAPOLIS-ST PAUL,9116,9116,0,8185,8185,0,11.374465
22/03/2018 09:29,201801,UNITED STATES OF AMERICA,USA,HEATHROW,NEW ORLEANS,6474,6474,0,0,0,0,0
22/03/2018 09:29,201801,UNITED STATES OF AMERICA,USA,HEATHROW,NEW YORK (JF KENNEDY),186478,186478,0,205225,205225,0,-9.134852
22/03/2018 09:29,201801,UNITED STATES OF AMERICA,USA,HEATHROW,NEW YORK (NEWARK),69207,69207,0,66070,66070,0,4.747995
22/03/2018 09:29,201801,UNITED STATES OF AMERICA,USA,HEATHROW,PHILADELPHIA INTERNATIONAL,38048,37739,309,33207,33207,0,14.578252
22/03/2018 09:29,201801,UNITED STATES OF AMERICA,USA,HEATHROW,PHOENIX,16425,16425,0,16543,16543,0,-0.713293
22/03/2018 09:29,201801,UNITED STATES OF AMERICA,USA,HEATHROW,RALEIGH,10121,10121,0,7757,7757,0,30.475699
22/03/2018 09:29,201801,UNITED STATES OF AMERICA,USA,HEATHROW,SALT LAKE CITY,0,0,0,4506,4506,0,-100
22/03/2018 09:29,201801,UNITED STATES OF AMERICA,USA,HEATHROW,SAN DIEGO,13558,13558,0,14232,14232,0,-4.735807
22/03/2018 09:29,201801,UNITED STATES OF AMERICA,USA,HEATHROW,SAN FRANCISCO,69412,69412,0,75014,75014,0,-7.467939
22/03/2018 09:29,201801,UNITED STATES OF AMERICA,USA,HEATHROW,SAN JOSE,6338,6338,0,6960,6960,0,-8.936782
22/03/2018 09:29,201801,UNITED STATES OF AMERICA,USA,HEATHROW,SEATTLE (TACOMA),26451,26451,0,23463,23463,0,12.734944
22/03/2018 09:29,201801,UNITED STATES OF AMERICA,USA,HEATHROW,WASHINGTON (DULLES),54583,54583,0,60423,60423,0,-9.665194
22/03/2018 09:29,201801,UNITED STATES OF AMERICA,USA,LONDON CITY,NEW YORK (JF KENNEDY),829,829,0,771,771,0,7.522698
22/03/2018 09:29,201801,UNITED STATES OF AMERICA,USA,BELFAST INTERNATIONAL,NEW YORK (NEWARK),0,0,0,2475,2475,0,-100
22/03/2018 09:29,201801,UNITED STATES OF AMERICA,USA,BELFAST INTERNATIONAL,NEWBURGH/USA,2317,2317,0,0,0,0,0
22/03/2018 09:29,201801,UNITED STATES OF AMERICA,USA,BIRMINGHAM,NEW YORK (JF KENNEDY),0,0,0,1656,1656,0,-100
22/03/2018 09:29,201801,UNITED STATES OF AMERICA,USA,BIRMINGHAM,NEW YORK (NEWARK),0,0,0,5088,5088,0,-100
22/03/2018 09:29,201801,UNITED STATES OF AMERICA,USA,EDINBURGH,NEW YORK (JF KENNEDY),1095,1095,0,2067,2067,0,-47.024673
22/03/2018 09:29,201801,UNITED STATES OF AMERICA,USA,EDINBURGH,NEW YORK (NEWARK),7518,7518,0,6774,6774,0,10.983171
22/03/2018 09:29,201801,UNITED STATES OF AMERICA,USA,EDINBURGH,NEWBURGH/USA,3921,3921,0,0,0,0,0
22/03/2018 09:29,201801,UNITED STATES OF AMERICA,USA,EDINBURGH,PROVIDENCE,1610,1610,0,0,0,0,0
22/03/2018 09:29,201801,UNITED STATES OF AMERICA,USA,EDINBURGH,WINDSOR LOCKS BRADLEY INTL,1468,1468,0,0,0,0,0
22/03/2018 09:29,201801,UNITED STATES OF AMERICA,USA,LEEDS BRADFORD,NEW YORK (NEWARK),221,221,0,224,224,0,-1.339286
22/03/2018 09:29,201801,UNITED STATES OF AMERICA,USA,MANCHESTER,ATLANTA,5808,5808,0,10801,10801,0,-46.227201
22/03/2018 09:29,201801,UNITED STATES OF AMERICA,USA,MANCHESTER,BOSTON,0,0,0,162,162,0,-100
22/03/2018 09:29,201801,UNITED STATES OF AMERICA,USA,MANCHESTER,CHICAGO (O'HARE),2467,2467,0,2407,2407,0,2.49273
22/03/2018 09:29,201801,UNITED STATES OF AMERICA,USA,MANCHESTER,HOUSTON,4541,4541,0,3404,3404,0,33.40188
22/03/2018 09:29,201801,UNITED STATES OF AMERICA,USA,MANCHESTER,MIAMI INTERNATIONAL,0,0,0,1045,1045,0,-100
22/03/2018 09:29,201801,UNITED STATES OF AMERICA,USA,MANCHESTER,NEW YORK (JF KENNEDY),13875,13875,0,10195,10195,0,36.096126
22/03/2018 09:29,201801,UNITED STATES OF AMERICA,USA,MANCHESTER,NEW YORK (NEWARK),9178,9178,0,9461,9461,0,-2.991227
22/03/2018 09:29,201801,UNITED STATES OF AMERICA,USA,MANCHESTER,ORLANDO,17288,17288,0,16319,16319,0,5.937864
22/03/2018 09:29,201801,UNITED STATES OF AMERICA,USA,MANCHESTER,PHILADELPHIA INTERNATIONAL,10102,10102,0,10604,10604,0,-4.734063
22/03/2018 09:29,201801,UNITED STATES OF AMERICA,USA,NEWCASTLE,NEW YORK (NEWARK),0,0,0,216,216,0,-100
22/03/2018 09:29,201801,CENTRAL AMERICA,COSTA RICA,GATWICK,LIBERIA,2998,0,2998,2901,0,2901,3.343675
22/03/2018 09:29,201801,CENTRAL AMERICA,COSTA RICA,GATWICK,SAN JOSE COST RICA,6671,6671,0,6687,6687,0,-0.23927
22/03/2018 09:29,201801,CENTRAL AMERICA,CUBA,GATWICK,HAVANA,8777,8777,0,9073,9073,0,-3.262427
22/03/2018 09:29,201801,CENTRAL AMERICA,CUBA,GATWICK,HOLGUIN (FRANK PAIS),3077,3077,0,2723,2723,0,13.000367
22/03/2018 09:29,201801,CENTRAL AMERICA,CUBA,GATWICK,VARADERO,2658,0,2658,2371,0,2371,12.104597
22/03/2018 09:29,201801,CENTRAL AMERICA,CUBA,BELFAST INTERNATIONAL,VARADERO,0,0,0,283,0,283,-100
22/03/2018 09:29,201801,CENTRAL AMERICA,CUBA,MANCHESTER,CUNAGUA (CAYO COCO),2781,2781,0,2495,2495,0,11.462926
22/03/2018 09:29,201801,CENTRAL AMERICA,CUBA,MANCHESTER,HOLGUIN (FRANK PAIS),3488,3488,0,3452,3452,0,1.042874
22/03/2018 09:29,201801,CENTRAL AMERICA,CUBA,MANCHESTER,VARADERO,2396,2396,0,2183,2183,0,9.757215
22/03/2018 09:29,201801,CENTRAL AMERICA,DOMINICAN REPUBLIC,GATWICK,LA ROMANA,2625,0,2625,0,0,0,0
22/03/2018 09:29,201801,CENTRAL AMERICA,DOMINICAN REPUBLIC,GATWICK,PUERTO PLATA,2966,0,2966,2673,0,2673,10.961467
22/03/2018 09:29,201801,CENTRAL AMERICA,DOMINICAN REPUBLIC,GATWICK,PUNTA CANA,11921,6021,5900,9800,4332,5468,21.642857
22/03/2018 09:29,201801,CENTRAL AMERICA,DOMINICAN REPUBLIC,BIRMINGHAM,LA ROMANA,2674,0,2674,0,0,0,0
22/03/2018 09:29,201801,CENTRAL AMERICA,DOMINICAN REPUBLIC,BIRMINGHAM,PUNTA CANA,0,0,0,2317,0,2317,-100
22/03/2018 09:29,201801,CENTRAL AMERICA,DOMINICAN REPUBLIC,MANCHESTER,LA ROMANA,2670,0,2670,0,0,0,0
22/03/2018 09:29,201801,CENTRAL AMERICA,DOMINICAN REPUBLIC,MANCHESTER,PUERTO PLATA,2926,0,2926,2937,0,2937,-0.374532
22/03/2018 09:29,201801,CENTRAL AMERICA,DOMINICAN REPUBLIC,MANCHESTER,PUNTA CANA,5313,0,5313,7973,0,7973,-33.362599
22/03/2018 09:29,201801,CENTRAL AMERICA,MEXICO,GATWICK,CANCUN,27432,27432,0,25210,14802,10408,8.813963
22/03/2018 09:29,201801,CENTRAL AMERICA,MEXICO,GATWICK,PUERTO VALLARTA,2729,0,2729,2352,0,2352,16.028912
22/03/2018 09:29,201801,CENTRAL AMERICA,MEXICO,HEATHROW,MEXICO CITY,18584,18584,0,19019,19019,0,-2.287186
22/03/2018 09:29,201801,CENTRAL AMERICA,MEXICO,STANSTED,CANCUN,0,0,0,2947,0,2947,-100
22/03/2018 09:29,201801,CENTRAL AMERICA,MEXICO,BIRMINGHAM,CANCUN,5251,5251,0,5297,0,5297,-0.868416
22/03/2018 09:29,201801,CENTRAL AMERICA,MEXICO,MANCHESTER,CANCUN,13297,13297,0,12968,5357,7611,2.537014
22/03/2018 09:29,201801,CENTRAL AMERICA,MEXICO,MANCHESTER,PUERTO VALLARTA,2353,0,2353,2682,0,2682,-12.266965
22/03/2018 09:29,201801,SOUTH AMERICA,ARGENTINA,HEATHROW,BUENOS AIRES,15203,15203,0,15773,15773,0,-3.61377
22/03/2018 09:29,201801,SOUTH AMERICA,BRAZIL,HEATHROW,RIO DE JANEIRO (GALEAO),10274,10274,0,10638,10638,0,-3.421696
22/03/2018 09:29,201801,SOUTH AMERICA,BRAZIL,HEATHROW,SAO PAULO (GUARULHOS),37964,37964,0,34590,34590,0,9.754264
22/03/2018 09:29,201801,SOUTH AMERICA,CHILE,HEATHROW,SANTIAGO DE CHILE,6708,6708,0,6399,6399,0,4.82888
22/03/2018 09:29,201801,SOUTH AMERICA,COLOMBIA,HEATHROW,BOGOTA,14184,14184,0,13999,13999,0,1.321523
22/03/2018 09:29,201801,SOUTH AMERICA,PERU,GATWICK,LIMA,0,0,0,3428,3428,0,-100
22/03/2018 09:29,201801,CARIBBEAN AREA,ANTIGUA AND BARBUDA,GATWICK,ANTIGUA,15918,15918,0,16101,16101,0,-1.136575
22/03/2018 09:29,201801,CARIBBEAN AREA,ANTIGUA AND BARBUDA,MANCHESTER,ANTIGUA,0,0,0,1104,1104,0,-100
22/03/2018 09:29,201801,CARIBBEAN AREA,BAHAMAS,HEATHROW,NASSAU,4852,4852,0,4712,4712,0,2.971138
22/03/2018 09:29,201801,CARIBBEAN AREA,BARBADOS,GATWICK,BRIDGETOWN,56536,41733,14803,53619,39560,14059,5.440236
22/03/2018 09:29,201801,CARIBBEAN AREA,BARBADOS,HEATHROW,BRIDGETOWN,4720,3705,1015,0,0,0,0
22/03/2018 09:29,201801,CARIBBEAN AREA,BARBADOS,BIRMINGHAM,BRIDGETOWN,6795,0,6795,7658,0,7658,-11.269261
22/03/2018 09:29,201801,CARIBBEAN AREA,BARBADOS,BOURNEMOUTH,BRIDGETOWN,0,0,0,576,0,576,-100
22/03/2018 09:29,201801,CARIBBEAN AREA,BARBADOS,BRISTOL,BRIDGETOWN,298,0,298,0,0,0,0
22/03/2018 09:29,201801,CARIBBEAN AREA,BARBADOS,CARDIFF WALES,BRIDGETOWN,895,0,895,1446,0,1446,-38.105118
22/03/2018 09:29,201801,CARIBBEAN AREA,BARBADOS,DONCASTER SHEFFIELD,BRIDGETOWN,597,0,597,597,0,597,0
22/03/2018 09:29,201801,CARIBBEAN AREA,BARBADOS,EAST MIDLANDS INTERNATIONAL,BRIDGETOWN,294,0,294,573,0,573,-48.691099
22/03/2018 09:29,201801,CARIBBEAN AREA,BARBADOS,GLASGOW,BRIDGETOWN,1188,0,1188,1946,0,1946,-38.951696
22/03/2018 09:29,201801,CARIBBEAN AREA,BARBADOS,MANCHESTER,BRIDGETOWN,21025,9815,11210,22553,8898,13655,-6.775152
22/03/2018 09:29,201801,CARIBBEAN AREA,BARBADOS,NEWCASTLE,BRIDGETOWN,871,871,0,295,295,0,195.254237
22/03/2018 09:29,201801,CARIBBEAN AREA,BERMUDA,GATWICK,BERMUDA,5358,5358,0,5624,5624,0,-4.72973
22/03/2018 09:29,201801,CARIBBEAN AREA,CAYMAN ISLANDS,HEATHROW,GRAND CAYMAN,2908,2908,0,2842,2842,0,2.322308
22/03/2018 09:29,201801,CARIBBEAN AREA,GRENADA,GATWICK,GRENADA,3296,3296,0,4888,4888,0,-32.569558
22/03/2018 09:29,201801,CARIBBEAN AREA,JAMAICA,GATWICK,KINGSTON,7408,7408,0,6843,6843,0,8.256613
22/03/2018 09:29,201801,CARIBBEAN AREA,JAMAICA,GATWICK,MONTEGO BAY,22473,11160,11313,20661,8951,11710,8.770147
22/03/2018 09:29,201801,CARIBBEAN AREA,JAMAICA,STANSTED,MONTEGO BAY,612,0,612,0,0,0,0
22/03/2018 09:29,201801,CARIBBEAN AREA,JAMAICA,BIRMINGHAM,MONTEGO BAY,2971,0,2971,5617,0,5617,-47.106997
22/03/2018 09:29,201801,CARIBBEAN AREA,JAMAICA,CARDIFF WALES,MONTEGO BAY,891,0,891,0,0,0,0
22/03/2018 09:29,201801,CARIBBEAN AREA,JAMAICA,GLASGOW,MONTEGO BAY,594,0,594,0,0,0,0
22/03/2018 09:29,201801,CARIBBEAN AREA,JAMAICA,MANCHESTER,MONTEGO BAY,7963,0,7963,7684,0,7684,3.630921
22/03/2018 09:29,201801,CARIBBEAN AREA,JAMAICA,NEWCASTLE,MONTEGO BAY,297,297,0,0,0,0,0
22/03/2018 09:29,201801,CARIBBEAN AREA,PUERTO RICO,GATWICK,SAN JUAN (PUERTO RICO),0,0,0,5284,5284,0,-100
22/03/2018 09:29,201801,CARIBBEAN AREA,SAINT KITTS AND NEVIS,GATWICK,ST KITTS,1477,1477,0,1561,1561,0,-5.381166
22/03/2018 09:29,201801,CARIBBEAN AREA,ST LUCIA,GATWICK,ST LUCIA (HEWANORRA),18999,16400,2599,15360,14310,1050,23.691406
22/03/2018 09:29,201801,CARIBBEAN AREA,ST LUCIA,MANCHESTER,ST LUCIA (HEWANORRA),2193,2193,0,1172,1172,0,87.116041
22/03/2018 09:29,201801,CARIBBEAN AREA,TRINIDAD AND TOBAGO,GATWICK,PORT OF SPAIN,4757,4757,0,4974,4974,0,-4.362686
22/03/2018 09:29,201801,CARIBBEAN AREA,TRINIDAD AND TOBAGO,GATWICK,TOBAGO,2999,2999,0,3063,3063,0,-2.089455
22/03/2018 09:29,201801,CARIBBEAN AREA,TRINIDAD AND TOBAGO,MANCHESTER,TOBAGO,1464,1464,0,1445,1445,0,1.314879
22/03/2018 09:29,201801,CARIBBEAN AREA,TURKS AND CAICOS ISLANDS,GATWICK,PROVIDENCIALES,1464,1464,0,1762,1762,0,-16.912599
22/03/2018 09:29,201801,INDIAN OCEAN ISLANDS,MALDIVE ISLANDS,GATWICK,MALE INTERNATIONAL,6273,6273,0,5792,5792,0,8.304558
22/03/2018 09:29,201801,INDIAN OCEAN ISLANDS,MALDIVE ISLANDS,HEATHROW,MALE INTERNATIONAL,0,0,0,515,515,0,-100
22/03/2018 09:29,201801,INDIAN OCEAN ISLANDS,MAURITIUS,GATWICK,MAURITIUS,12871,12871,0,9529,9529,0,35.071886
22/03/2018 09:29,201801,INDIAN OCEAN ISLANDS,MAURITIUS,HEATHROW,MAURITIUS,6397,6397,0,6993,6993,0,-8.522809
22/03/2018 09:29,201801,INDIAN OCEAN ISLANDS,MAURITIUS,MANCHESTER,MAURITIUS,0,0,0,1089,1089,0,-100
22/03/2018 09:29,201801,ATLANTIC OCEAN ISLANDS,CAPE VERDE ISLANDS,GATWICK,BOA VISTA (RABIL),5447,5447,0,5442,3708,1734,0.091878
22/03/2018 09:29,201801,ATLANTIC OCEAN ISLANDS,CAPE VERDE ISLANDS,GATWICK,ILHA DO SAL C.VERDE,9083,9083,0,9135,7498,1637,-0.569239
22/03/2018 09:29,201801,ATLANTIC OCEAN ISLANDS,CAPE VERDE ISLANDS,BIRMINGHAM,BOA VISTA (RABIL),2041,2041,0,1490,1490,0,36.979866
22/03/2018 09:29,201801,ATLANTIC OCEAN ISLANDS,CAPE VERDE ISLANDS,BIRMINGHAM,ILHA DO SAL C.VERDE,4726,4726,0,3536,3536,0,33.653846
22/03/2018 09:29,201801,ATLANTIC OCEAN ISLANDS,CAPE VERDE ISLANDS,BRISTOL,ILHA DO SAL C.VERDE,1660,0,1660,1646,1646,0,0.850547
22/03/2018 09:29,201801,ATLANTIC OCEAN ISLANDS,CAPE VERDE ISLANDS,GLASGOW,ILHA DO SAL C.VERDE,1589,0,1589,1610,0,1610,-1.304348
22/03/2018 09:29,201801,ATLANTIC OCEAN ISLANDS,CAPE VERDE ISLANDS,MANCHESTER,BOA VISTA (RABIL),5334,5334,0,5308,5308,0,0.489827
22/03/2018 09:29,201801,ATLANTIC OCEAN ISLANDS,CAPE VERDE ISLANDS,MANCHESTER,ILHA DO SAL C.VERDE,5531,5531,0,7681,7681,0,-27.991147
22/03/2018 09:29,201801,OIL RIGS,OIL RIGS,ABERDEEN,OIL RIGS,26427,0,26427,28839,0,28839,-8.363674
22/03/2018 09:29,201801,OIL RIGS,OIL RIGS,BLACKPOOL,OIL RIGS,1781,0,1781,1465,0,1465,21.569966
22/03/2018 09:29,201801,OIL RIGS,OIL RIGS,HUMBERSIDE,OIL RIGS,1444,0,1444,1042,0,1042,38.579655
22/03/2018 09:29,201801,OIL RIGS,OIL RIGS,NORWICH,OIL RIGS,8018,972,7046,8304,0,8304,-3.444123
22/03/2018 09:29,201801,OIL RIGS,OIL RIGS,SCATSTA,OIL RIGS,6777,0,6777,5508,0,5508,23.039216

